(If Loving You Is Wrong) I Don't Want To Be Right : Luther Ingram
(Last Night) I Didn't Get To Sleep At All : The 5th Dimension
A Cowboys Work Is Never Done : Sonny & Cher
A Horse With No Name : America
Alone Again (Naturally) : Gilbert O'Sullivan
American Pie (Parts I & II) : Don McLean
An Old Fashioned Love Song : Three Dog Night
Baby Don't Get Hooked On Me : Mac Davis
Back Off Boogaloo : Ringo Starr
Back Stabbers : The O'Jays
Bang A Gong (Get It On) : T. Rex
Ben : Michael Jackson
Betcha By Golly, Wow : The Stylistics Featuring Russell Thompkins,Jr.
Black & White : Three Dog Night
Brand New Key : Melanie
Brandy (You're A Fine Girl) : Looking Glass
Burning Love : Elvis Presley
Cherish : David Cassidy
Clair : Gilbert O'Sullivan
Clean Up Woman : Betty Wright
Coconut : Nilsson
Convention '72 : The Delegates
Daddy Don't You Walk So Fast : Wayne Newton
Day After Day : Badfinger
Day Dreaming : Aretha Franklin
Doctor My Eyes : Jackson Browne
Down By The Lazy River : The Osmonds
Everybody Plays The Fool : The Main Ingredient
Everything I Own : Bread
Family Affair : Sly & The Family Stone
Freddie's Dead (Theme From Superfly) : Curtis Mayfield
Funny Face : Donna Fargo
Garden Party : Rick Nelson and The Stone Canyon Band
Go All The Way : Raspberries
Good Time Charlie's Got The Blues : Danny O'Keefe
Goodbye To Love : Carpenters
Got To Be There : Michael Jackson
Have You Seen Her : The Chi-lites
Heart Of Gold : Neil Young
Hey Girl/I Knew You When : Donny Osmond
Hold Your Head Up : Argent
Honky Cat : Elton John
Hot Rod Lincoln : Commander Cody & His Lost Planet Airmen
How Do You Do? : Mouth & MacNeal
Hurting Each Other : Carpenters
I Am Woman : Helen Reddy
I Can See Clearly Now : Johnny Nash
I Gotcha : Joe Tex
I Need You : America
I'd Like To Teach The World To Sing (In Perfect Harmony) : The New Seekers
I'd Love You To Want Me : Lobo
I'll Be Around/How Could I Let You Get Away : The Spinners
I'll Take You There : The Staple Singers
I'm Still In Love With You : Al Green
I'm Stone In Love With You : The Stylistics
If I Could Reach You : The 5th Dimension
If You Don't Know Me By Now : Harold Melvin And The Blue Notes
In The Rain : The Dramatics
It Never Rains In Southern California : Albert Hammond
Joy : Apollo featuring Tom Parker
Jungle Fever : The Chakachas
Layla : Derek & The Dominos
Lean On Me : Bill Withers
Let's Stay Together : Al Green
Long Cool Woman (In A Black Dress) : The Hollies
Look What You Done For Me : Al Green
Me And Mrs. Jones : Billy Paul
Morning Has Broken : Cat Stevens
Mother And Child Reunion : Paul Simon
My Ding-A-Ling : Chuck Berry
Never Been To Spain : Three Dog Night
Nice To Be With You : Gallery
Nights In White Satin : The Moody Blues
Oh Girl : The Chi-lites
Outa-Space : Billy Preston
Papa Was A Rollin' Stone : The Temptations
Popcorn : Hot Butter
Precious And Few : Climax
Puppy Love : Donny Osmond
Rock And Roll Part 2 : Gary Glitter
Rocket Man : Elton John
Rockin' Pneumonia - Boogie Woogie Flu : Johnny Rivers
Rockin' Robin : Michael Jackson
Saturday In The Park : Chicago
School's Out : Alice Cooper
Scorpio : Dennis Coffey & The Detroit Guitar Band
Song Sung Blue : Neil Diamond
Sugar Daddy : Jackson 5
Summer Breeze : Seals & Crofts
Sunshine : Jonathan Edwards
Superfly : Curtis Mayfield
Sweet Seasons : Carole King
Sylvia's Mother : Dr. Hook And The Medicine Show
The Candy Man : Sammy Davis, Jr. with The Mike Curb Congregation
The First Time Ever I Saw Your Face : Roberta Flack
The Lion Sleeps Tonight : Robert John
The Way Of Love : Cher
Too Late To Turn Back Now : Cornelius Brothers & Sister Rose
Troglodyte (Cave Man) : The Jimmy Castor Bunch
Tumbling Dice : The Rolling Stones
Use Me : Bill Withers
Ventura Highway : America
Where Is The Love : Roberta Flack & Donny Hathaway
Witchy Woman : Eagles
Without You : Nilsson
You Are Everything : The Stylistics
You Don't Mess Around With Jim : Jim Croce
You Ought To Be With Me : Al Green
You're So Vain : Carly Simon
Your Mama Don't Dance : Kenny Loggins & Jim Messina
