(God Must Have Spent) A Little More Time On You : N Sync
(You Drive Me) Crazy : Britney Spears
...Baby One More Time : Britney Spears
24/7 : Kevon Edmonds
808 : Blaque
All I Have To Give : Backstreet Boys
All Night Long : Faith Evans Featuring Puff Daddy
All Star : Smash Mouth
Angel : Sarah McLachlan
Angel Of Mine : Monica
Back At One : Brian McKnight
Bailamos : Enrique Iglesias
Because Of You : 98 Degrees
Believe : Cher
Bills, Bills, Bills : Destiny s Child
Bring It All To Me : Blaque
C est La Vie : B*Witched
Chante s Got A Man : Chante Moore
Doo Wop (That Thing) : Lauryn Hill
Every Morning : Sugar Ray
Faded Pictures : Case
Fortunate : Maxwell
From This Moment On : Shania Twain
Genie In A Bottle : Christina Aguilera
Girl On TV : LFO
Give It To You : Jordan Knight
Hands : Jewel
Have You Ever? : Brandy
Heartbreak Hotel : Whitney Houston Feat. Faith Evans
Heartbreaker : Mariah Carey Featuring Jay-Z
Hot Boyz : Missy "Misdemeanor" Elliott Featuring NAS, EVE & Q-Tip
I Knew I Loved You : Savage Garden
I Need To Know : Marc Anthony
I Still Believe : Mariah Carey
I Wanna Love You Forever : Jessica Simpson
I Want It That Way : Backstreet Boys
I m Your Angel : R. Kelly
If You Had My Love : Jennifer Lopez
It s Not Right But It s Okay : Whitney Houston
Jamboree : Naughty By Nature Featuring Zhane
Jumper : Third Eye Blind
Kiss Me : Sixpence None The Richer
Last Kiss : Pearl Jam
Lately : Divine
Livin La Vida Loca : Ricky Martin
Lost In You : Garth Brooks as Chris Gaines
Love Like This : Faith Evans
Lullaby : Shawn Mullins
Mambo No. 5 (A Little Bit Of...) : Lou Bega
Music Of My Heart : N Sync
My Love Is Your Love : Whitney Houston
No Scrubs : TLC
Nobody s Supposed To Be Here : Deborah Cox
Please Remember Me : Tim McGraw
Satisfy You : Puff Daddy Featuring R. Kelly
Save Tonight : Eagle-Eye Cherry
Scar Tissue : Red Hot Chili Peppers
She s All I Ever Had : Ricky Martin
Slide : Goo Goo Dolls
Smooth : Santana Featuring Rob Thomas
Someday : Sugar Ray
Stay The Same : Joey McIntyre
Steal My Sunshine : Len
Summer Girls : LFO
Tell Me It s Real : K-Ci
That Don t Impress Me Much : Shania Twain
The Hardest Thing : 98 Degrees
Trippin : Total Featuring Missy Elliott
U Know What s Up : Donell Jones
U Know What's Up : Donell Jones
Unpretty : TLC
Waiting For Tonight : Jennifer Lopez
We Can t Be Friends : Deborah Cox With R.L.
What s It Gonna Be?! : Busta Rhymes Featuring Janet
Where My Girls At? : 702
Who Dat : JT Money Featuring Sole
Wild Wild West : Will Smith Featuring Dru Hill
You : Jesse Powell
