4 Minutes : Madonna Featuring Justin Timberlake
7 Things : Miley Cyrus
A Milli : Lil Wayne
American Boy : Estelle Featuring Kanye West
Apologize : Timbaland Featuring OneRepublic
Bleeding Love : Leona Lewis
Bubbly : Colbie Caillat
Burnin' Up : Jonas Brothers
Bust It Baby Part 2 : Plies Featuring Ne-Yo
Can't Believe It : T-Pain Featuring Lil Wayne
Change : Taylor Swift
Circus : Britney Spears
Closer : Ne-Yo
Clumsy : Fergie
Crank That (Soulja Boy) : Soulja Boy Tell'em
Crush : David Archuleta
Damaged : Danity Kane
Dangerous : Kardinal Offishall Featuring Akon
Disturbia : Rihanna
Don't Stop The Music : Rihanna
Fearless : Taylor Swift
Forever : Chris Brown
Got Money : Lil Wayne Featuring T-Pain
Gotta Be Somebody : Nickelback
Hate That I Love You : Rihanna Featuring Ne-Yo
Heartless : Kanye West
Hot N Cold : Katy Perry
I Kissed A Girl : Katy Perry
I'm Yours : Jason Mraz
If I Were A Boy : Beyonce
In The Ayer : Flo Rida Featuring will.i.am
Independent : Webbie, Lil' Phat & Lil' Boosie
Just Dance : Lady GaGa Featuring Colby O'Donis
Keeps Gettin' Better : Christina Aguilera
Kiss Kiss : Chris Brown Featuring T-Pain
Leavin' : Jesse McCartney
Let It Rock : Kevin Rudolf Featuring Lil Wayne
Live Your Life : T.I. Featuring Rihanna
Lollipop : Lil Wayne Featuring Static Major
Love In This Club : Usher Featuring Young Jeezy
Love Lockdown : Kanye West
Love Song : Sara Bareilles
Love Story : Taylor Swift
Low : Flo Rida Featuring T-Pain
Miss Independent : Ne-Yo
New Soul : Yael Naim
No Air : Jordin Sparks Duet With Chris Brown
No One : Alicia Keys
Paper Planes : M.I.A.
Paralyzer : Finger Eleven
Pocketful Of Sunshine : Natasha Bedingfield
Right Now (Na Na Na) : Akon
See You Again : Miley Cyrus
Sensual Seduction : Snoop Dogg
Sexy Can I : Ray J & Yung Berg
Shake It : Metro Station
Shawty Get Loose : Lil Mama Featuring Chris Brown & T-Pain
Single Ladies (Put A Ring On It) : Beyonce
So What : Pink
Sorry : Buckcherry
Superstar : Lupe Fiasco Featuring Matthew Santos
Swagga Like Us : Jay-Z & T.I. Featuring Kanye West & Lil Wayne
Take A Bow : Rihanna
Take You There : Sean Kingston
Tattoo : Jordin Sparks
The Time Of My Life : David Cook
This Is Me : Demi Lovato & Joe Jonas
Tonight : Jonas Brothers
Touch My Body : Mariah Carey
Viva La Vida : Coldplay
Whatever You Like : T.I.
When I Grow Up : The Pussycat Dolls
With You : Chris Brown
Womanizer : Britney Spears
