(Here They Come) From All Over The World : Jan & Dean
(I Can't Get No) Satisfaction : The Rolling Stones
(My Girl) Sloopy : Little Caesar And The Consuls
(Say) You're My Girl : Roy Orbison
(Such An) Easy Question : Elvis Presley With The Jordanaires
1-2-3 : Len Barry
10 Little Bottles : Johnny Bond
3rd Man Theme : Herb Alpert & The Tijuana Brass
A Little Bit Of Heaven : Ronnie Dove
A Little Bit Of Soap : Garnet Mimms
A Little You : Freddie And The Dreamers
A Lover's Concerto : The Toys
A Time To Love-A Time To Cry (Petite Fleur) : Lou Johnson
A Walk In The Black Forest : Horst Jankowski
A World Of Our Own : The Seekers
A Young Girl : Noel Harrison
Action : Freddy Cannon
After Loving You : Della Reese
Agent Double-O-Soul : Edwin Starr
Ain't It True : Andy Williams
All I Really Want To Do : Cher
All Or Nothing : Patti LaBelle And The Blue Belles
And I Love Him : Esther Phillips
Annie Fanny : The Kingsmen
Apache '65 : The Arrows Featuring Davie Allan
Apples And Bananas : Lawrence Welk And His Orchestra
Are You A Boy Or Are You A Girl : The Barbarians
Are You Still My Baby : The Shirelles
Around The Corner : The Duprees
Baby, I'm Yours : Barbara Lewis
Be My Baby : Dick and DeeDee
Black Nights : Lowell Fulsom
Blind Man : Little Milton
Blue Shadows : B.B. King
Boo-Ga-Loo : Tom and Jerrio
Boot-Leg : Booker T. & The MG's
Born To Be Together : The Ronettes Featuring Veronica
Buckaroo : Buck Owens and The Buckaroos
C.C. Rider : Bobby Powell
California Girls : The Beach Boys
Can't You Just See Me : Aretha Franklin
Canadian Sunset : Sounds Orchestral
Candy : The Astors
Cara, Mia : Jay & The Americans
Chim, Chim, Cheree : The New Christy Minstrels
Come Back Baby : Roddie Joy
Come See : Major Lance
Come Tomorrow : Manfred Mann
Concrete And Clay : Eddie Rambeau
Concrete And Clay : Unit Four plus Two
Crazy Downtown : Allan Sherman
Crying In The Chapel : Adam Wade
Dance With Me : The Mojo Men
Danger Heartbreak Dead Ahead : The Marvelettes
Darling Take Me Back : Lenny Welch
Dear Heart : Henry Mancini And His Orchestra
Diamond Head : The Ventures
Diana : Bobby Rydell
Did You Ever : The Hullaballoos
Do Anything You Wanna (Part I) : Harold Betters
Do I Make Myself Clear : Etta James & Sugar Pie DeSanto
Do The Clam : Elvis Presley With The Jordanaires, Jubilee Four & Carol Lombard Trio
Do What You Do Do Well : Ned Miller
Do You Believe In Magic : The Lovin' Spoonful
Does He Really Care For Me : Ruby And The Romantics
Don't Come Running Back To Me : Nancy Wilson
Don't Have To Shop Around : The Mad Lads
Don't Just Stand There : Patty Duke
Don't Mess Up A Good Thing : Fontella Bass & Bobby McClure
Don't Think Twice : The Wonder Who?
Double-O-Seven : The Detergents
Down In The Boondocks : Billy Joe Royal
Dusty : The Rag Dolls
El Pussy Cat : Mongo Santamaria
Eve Of Destruction : Barry McGuire
Every Night, Every Day : Jimmy McCracklin
Everybody Do The Sloopy : Johnny Thunder
Everyone's Gone To The Moon : Jonathan King
Fancy Pants : Al (He's the King) Hirt
Find My Way Back Home : The Nashville Teens
Finders Keepers, Losers Weepers : Nella Dodds
First I Look At The Purse : The Contours
Flowers On The Wall : The Statler Brothers
Fly Me To The Moon (In Other Words) : Tony Bennett
Fly Me To The Moon : LaVern Baker
For Lovin' Me : Peter, Paul & Mary
For Mama : Jerry Vale
For You : The Spellbinders
For Your Love : Sam & Bill
For Your Love : The Yardbirds
Forget Domani : Connie Francis
Forget Domani : Frank Sinatra
Gee Baby (I'm Sorry) : The Three Degrees
Getting Mighty Crowded : Betty Everett
Girl Come Running : The 4 Seasons Featuring the Sound of Frankie Valli
Girl Don't Come : Sandie Shaw
Girl On The Billboard : Del Reeves
Give All Your Love To Me : Gerry And The Pacemakers
Go Now! : The Moody Blues
Goldfinger : Billy Strange
Goldfinger : Jack Laforge His Piano and Orchestra
Goldfinger : John Barry and His Orchestra
Goldfinger : Shirley Bassey
Good Lovin' : The Olympics
Good Times : Jerry Butler
Gotta Have Your Love : The Sapphires
Hang On Sloopy : The McCoys
Harlem Nocturne : The Viscounts
Hawaii Tattoo : The Waikikis
He Was Really Sayin' Somethin' : The Velvelettes
He's Got No Love : The Searchers
He's My Guy : Irma Thomas
Heartaches By The Number : Johnny Tillotson
Hello, Dolly! : Bobby Darin
Here Comes The Night : Them
Here I Am : Dionne Warwick
Hey-Da-Da-Dow : The Dolphins
High Heel Sneakers : Stevie Wonder
Hold Me, Thrill Me, Kiss Me : Mel Carter
Hole In The Wall : The Packers
Home Of The Brave : Bonnie & The Treasures
Honky Tonk '65 : Lonnie Mack
Houston : Dean Martin
Hungry For Love : San Remo Golden Strings
I Ain't Gonna Eat Out My Heart Anymore : The Young Rascals
I Can Never Go Home Anymore : The Shangri-Las
I Can't Explain : The Who
I Can't Help Myself (Sugar Pie Honey Bunch) : Four Tops
I Can't Stop : The Honeycombs
I Can't Stop Thinking Of You : Bobbi Martin
I Can't Work No Longer : Billy Butler & The Chanters
I Do : The Marvelows
I Don't Know What You've Got But It's Got Me - Part I : Little Richard
I Don't Wanna Lose You Baby : Chad & Jeremy
I Found A Love Oh What A Love : Jo Ann & Troy
I Got You Babe : Sonny & Cher
I Gotta Woman (Part One) : Ray Charles and his Orchestra
I Like It Like That : The Dave Clark Five
I Live For The Sun : The Sunrays
I Really Love You : Dee Dee Sharp
I Still Love You : The Vejtables
I Wanna Be (Your Everything) : The Manhattans
I Want Candy : The Strangeloves
I Want My Baby Back : Jimmy Cross
I Want To (Do Everything For You) : Joe Tex
I Want You To Be My Boy : The Exciters
I'll Always Love You : The Spinners
I'll Take You Where The Music's Playing : The Drifters
I'm A Fool : Dino, Desi & Billy
I'm A Fool To Care : Ray Charles
I'm A Happy Man : The Jive Five (featuring Eugene Pitt)
I'm Henry VIII, I Am : Herman's Hermits
I'm Over You : Jan Bradley
I'm Satisfied : The San Remo Golden Strings
I'm Yours : Elvis Presley
I've Cried My Last Tear : The O'Jays
I've Got A Tiger By The Tail : Buck Owens
I've Got Five Dollars And It's Saturday Night : George & Gene
If I Didn't Love You : Chuck Jackson
If You Really Want Me To, I'll Go : The Ron-Dels
If You've Got A Heart : Bobby Goldsboro
In The Midnight Hour : Wilson Pickett
Inky Dinky Spider (The Spider Song) : The Kids Next Door
Is It Really Over? : Jim Reeves
It Ain't Me Babe : The Turtles
It Ain't No Big Thing : Radiants
It's A Man Down There : G.L. Crockett
It's Almost Tomorrow : Jimmy Velvet
It's Alright : Adam Faith With The Roulettes
It's Better To Have It : Barbara Lynn
It's Gonna Be Fine : Glenn Yarbrough
It's Gonna Take A Miracle : The Royalettes
It's Good News Week : Hedgehoppers Anonymous
It's Just A Little Bit Too Late : Wayne Fontana & The Mindbenders
It's Too Late, Baby Too Late : Arthur Prysock
It's Wonderful To Be In Love : The Ovations (featuring Louis Williams)
Jenny Take A Ride! : Mitch Ryder And The Detroit Wheels
Jerk And Twine : Jackie Ross
Just A Little Bit : Roy Head
Just Like Me : Paul Revere & The Raiders Featuring Mark Lindsay
Just One Kiss From You : The Impressions
Keep On Dancing : The Gentrys
Keep On Trying : Bobby Vee
Land Of 1000 Dances : Cannibal And The Headhunters
Land Of A Thousand Dances (Part I) : Thee Midniters
Laugh At Me : Sonny
Laurie (Strange Things Happen) : Dickey Lee
Let's Move & Groove (Together) : Johnny Nash
Liar, Liar : The Castaways
Lies : The Knickerbockers
Lightnin' Strikes : Lou Christie
Like A Rolling Stone : Bob Dylan
Little Bell : The Dixie Cups
Little Boy (In Grown Up Clothes) : The 4 Seasons
Little Miss Sad : The Five Emprees
Look Through Any Window : The Hollies
Looking Through The Eyes Of Love : Gene Pitney
Losing You : Dusty Springfield
Love Is A 5-Letter Word : James Phelps
Love Me As Though There Were No Tomorrow : Sonny Knight
Lovely, Lovely (Loverly, Loverly) : Chubby Checker
Lovin' Place : Gale Garnett
Make It Easy On Yourself : The Walker Bros.
Make The World Go Away : Eddy Arnold
Marie : The Bachelors
Married Man : Richard Burton
May The Bird Of Paradise Fly Up Your Nose : Little Jimmy Dickens
Mean Old World : Rick Nelson
Mexican Pearls : Billy Vaughn And His Orchestra
Michael : The C.O.D.'s
Misty : The Vibrations
Mohair Sam : Charlie Rich
Moon Over Naples : Bert Kaempfert And His Orchestra
Moonlight And Roses (Bring Mem'ries Of You) : Vic Dana
Mother Nature, Father Time : Brook Benton
Mr. Tambourine Man : The Byrds
My Buddy Seat : The Hondells
My Love, Forgive Me (Amore, Scusami) : Robert Goulet
My Man : Barbra Streisand
N-E-R-V-O-U-S! : Ian Whitcomb
Never, Never Leave Me : Mary Wells
New Orleans : Eddie Hodges
New York's A Lonely Town : The Trade Winds
No Faith, No Love : Mitty Collier
No Matter What Shape (Your Stomach's In) : The T-Bones
No Pity (In The Naked City) : Jackie Wilson
Nobody Knows What's Goin' On (In My Mind But Me) : The Chiffons
Not Too Long Ago : The Uniques Featuring Joe Stampley
Nothing But Heartaches : The Supremes
Now That You've Gone : Connie Stevens
Ode To The Little Brown Shack Out Back : Billy Edd Wheeler
On A Clear Day You Can See Forever : Johnny Mathis
One Dyin' And A Buryin' : Roger Miller
One Has My Name (The Other Has My Heart) : Barry Young
One Step At A Time : Maxine Brown
Only Those In Love : Baby Washington
Oo Wee Baby, I Love You : Fred Hughes
Oowee, Oowee : Perry Como
Orange Blossom Special : Johnny Cash
Papa's Got A Brand New Bag (Part I) : James Brown And The Famous Flames
Paper Tiger : Sue Thompson
Pass Me By : Peggy Lee
Peaches N Cream : The Ikettes
Peanuts (La Cacahuata) : The Sunglows
Percolatin' : Willie Mitchell
Pied Piper : The Changin' Times
Poor Man's Son : The Reflections
Pretty Little Baby : Marvin Gaye
Promised Land : Chuck Berry
Rainbow '65 (Part I) : Gene Chandler
Real Live Girl : Steve Alaimo
Rescue Me : Fontella Bass
Respect : Otis Redding
Ride Your Pony : Lee Dorsey
Ringo : Lorne Greene
Road Runner : The Gants
Roses And Rainbows : Danny Hutton
Roses Are Red My Love : The You Know Who Group!
Run, Baby Run (Back Into My Arms) : The Newbeats
Run, Run, Run : The Gestures
Sandy : Ronny And The Daytonas
Save Your Heart For Me : Gary Lewis And The Playboys
Seein' The Right Love Go Wrong : Jack Jones
Seesaw : Don Covay & The Goodtimers
Set Me Free : The Kinks
Seven Letters : Ben E. King
Seventh Son : Johnny Rivers
Shake And Fingerpop : Jr. Walker & The All Stars
Shakin' All Over : The Guess Who
She's About A Mover : Sir Douglas Quintet
She's With Her Other Love : Leon Hayward
Silver Threads And Golden Needles : Jody Miller
Since I Lost My Baby : The Temptations
Sinner Man : Trini Lopez
Sitting In The Park : Billy Stewart
Smile : Betty Everett & Jerry Butler
So Long Babe : Nancy Sinatra
So What : Bill Black's Combo
Something You Got : Chuck Jackson & Maxine Brown
Somewhere : P.J. Proby
Soul Heaven : The Dixie Drifter
Soul Sauce (Guacha Guaro) : Cal Tjader
Spanish Eyes : Al Martino
Spanish Harlem : King Curtis
Stand By Me : Earl Grant
Stay Away From My Baby : Ted Taylor
Steppin' Out : Paul Revere & The Raiders
Stop! Look What You're Doing : Carla Thomas
Stranger In Town : Del Shannon
Sugar Dumpling : Sam Cooke
Summer Nights : Marianne Faithfull
Summer Wind : Wayne Newton
Sunshine, Lollipops And Rainbows : Lesley Gore
Super-cali-fragil-istic-expi-ali-docious : Julie Andrews-Dick Van Dyke
Take Me Back : Little Anthony And The Imperials
Take Me In Your Arms (Rock Me A Little While) : Kim Weston
Take This Hurt Off Me : Don Covay
Talk About Love : Adam Faith
Teasin' You : Willie Tee
Tell Her No : The Zombies
Temptation 'Bout To Get Me : The Knight Bros.
The 81 : Candy & The Kisses
The Birds And The Bees : Jewel Akens
The Boy From New York City : The Ad Libs
The Clapping Song (Clap Pat Clap Slap) : Shirley Ellis
The Crusher : The Novas
The Dawn Of Correction : The Spokesmen
The Duck : Jackie Lee
The Entertainer : Tony Clarke
The First Thing Ev'ry Morning (And The Last Thing Ev'ry Night) : Jimmy Dean
The In Crowd : Dobie Gray
The In Crowd : Ramsey Lewis Trio
The Jerk : The Larks
The Loser : The Skyliners
The Men In My Little Girl's Life : Mike Douglas
The Mouse : Soupy Sales
The Organ Grinder's Swing : Jimmy Smith With Kenny Burrell And Grady Tate
The Race Is On : George Jones
The Sidewinder, Part 1 : Lee Morgan
The Silence (Il Silenzio) : Al Hirt
The Sins Of A Family : P.F. Sloan
The Sound Of Silence : Simon & Garfunkel
The Tracks Of My Tears : The Miracles
The Universal Soldier : Glen Campbell
The Way Of Love : Kathy Kirby
The Wedding : Julie Rogers
The World Through A Tear : Neil Sedaka
Theme From A Summer Place : The Lettermen
Theme From Harlow (Lonely Girl) : Bobby Vinton
There But For Fortune : Joan Baez
These Hands (Small But Mighty) : Bobby Bland
This Is My Prayer : The Ray Charles Singers
Three O'Clock In The Morning : Lou Rawls
To Know You Is To Love You : Peter And Gordon
Tonight's The Night : Solomon Burke
Too Many Rivers : Brenda Lee
Tossing & Turning : The Ivy League
Trains And Boats And Planes : Billy J. Kramer With The Dakotas
Treat Her Right : Roy Head And The Traits
Try Me : James Brown At The Organ
Try To Remember : Ed Ames
Try To Remember : Roger Williams
Try To Remember : The Brothers Four
Twine Time : Alvin Cash & The Crawlers
Unchained Melody : The Righteous Brothers
Universal Soldier : Donovan
Voice Your Choice : The Radiants
Walk Away : Matt Monro
Walking In The Rain : The Ronettes
Watermelon Man : Gloria Lynne
We Gotta Get Out Of This Place : The Animals
We're Doing Fine : Dee Dee Warwick
Welcome Home : Walter Jackson
What Are We Going To Do? : David Jones
What The World Needs Now Is Love : Jackie DeShannon
What's New Pussycat? : Tom Jones
When I'm Gone : Brenda Holloway
Whenever A Teenager Cries : Reparata And The Delrons
Whipped Cream : Herb Alpert's Tijuana Brass
Wooly Bully : Sam The Sham and the Pharaohs
Yakety Axe : Chet Atkins
Yeh, Yeh : Georgie Fame And The Blue Flames
Yes, I'm Ready : Barbara Mason
Yesterday : The Beatles
You Better Go : Derek Martin
You Can Have Him : Timi Yuro
You Can't Be True, Dear : Patti Page
You Tell Me Why : The Beau Brummels
You Turn Me On (Turn On Song) : Ian Whitcomb And Bluesville
You Were On My Mind : We Five
You Were Only Fooling (While I Was Falling In Love) : Vic Damone
You'd Better Come Home : Petula Clark
You're Gonna Make Me Cry : O.V. Wright
You're My Baby (And Don't You Forget It) : The Vacels
You're Next : Jimmy Witherspoon
You're The One : The Vogues
You're The Only World I Know : Sonny James
You've Been In Love Too Long : Martha & The Vandellas
You've Got To Hide Your Love Away : The Silkie
You've Got Your Troubles : The Fortunes
