(I'm So) Afraid Of Losing You Again : Charley Pride
(One Of These Days) Sunday's Gonna' Come On Tuesday : The New Establishment
(We've Got) Honey Love : Martha Reeves & The Vandellas
30-60-90 : Willie Mitchell
A Brand New Me : Dusty Springfield
A Million To One : Brian Hyland
Abergavenny : Shannon
Abraham, Martin And John : Moms Mabley
Ain't Got No; I Got Life : Nina Simone
Ain't It Funky Now (Part 1) : James Brown
Alice's Rock & Roll Restaurant : Arlo Guthrie
All God's Children Got Soul : Dorothy Morrison
Almost Persuaded : Etta James
Along Came Jones : Ray Stevens
Am I The Same Girl : Barbara Acklin
And She's Mine : Spanky And Our Gang
And That Reminds Me (My Heart Reminds Me) : The 4 Seasons
And When I Die : Blood, Sweat & Tears
Any Day Now : Percy Sledge
Any Way That You Want Me : Evie Sands
Apricot Brandy : Rhinoceros
Arizona : Mark Lindsay
Armstrong : John Stewart
Atlantis : Donovan
Baby It's You : Smith
Baby Let's Wait : The Royal Guardsmen
Baby, I'm For Real : The Originals
Back In The U.S.S.R. : Chubby Checker
Backfield In Motion : Mel And Tim
Badge : Cream
Ball Of Fire : Tommy James And The Shondells
Ballad Of Easy Rider : The Byrds
Battle Hymn Of The Republic : Andy Williams with the St. Charles Borromeo Choir
Big Bruce : Steve Greenberg
Big In Vegas : Buck Owens and The Buckaroos
Birthday : Underground Sunshine
Black Pearl : Sonny Charles & The Checkmates, Ltd.
Blistered/See Ruby Fall : Johnny Cash
Bubble Gum Music : Rock & Roll Double Bubble
But It's Alright : J.J. Jackson
But You Know I Love You : The First Edition
Buying A Book : Joe Tex
By The Time I Get To Phoenix : Isaac Hayes
By The Time I Get To Phoenix : The Mad Lads
California Dreamin' : Bobby Womack
California Girl (And The Tennessee Square) : Tompall & The Glaser Brothers
Camel Back : A.B. Skhy
Can't Find The Time : Orpheus
Can't Take My Eyes Off You : Nancy Wilson
Carry Me Back : The Rascals
Chains Of Love : Bobby Bland
Cherry Hill Park : Billy Joe Royal
Chitty Chitty Bang Bang : Paul Mauriat
Cinnamon : Derek
Cold Turkey : Plastic Ono Band
Come Saturday Morning : The Sandpipers
Come Together/Something : The Beatles
Condition Red : The Goodees
Crosstown Traffic : The Jimi Hendrix Experience
Crumbs Off The Table : The Glass House
Cupid : Johnny Nash
Curly : Jimmy Clanton
Daddy's Little Man : O.C. Smith
Dammit Isn't God's Last Name : Frankie Laine
Day After Day (It's Slippin' Away) : Shango
Did You See Her Eyes : The Illusion
Didn't We : Richard Harris
Do Your Thing : The Watts 103rd Street Rhythm Band
Doin' Our Thing : Clarence Carter
Don't Forget To Remember : Bee Gees
Don't It Make You Want To Go Home : Joe South and The Believers
Don't Let Him Take Your Love From Me : Four Tops
Don't Let Love Hang You Up : Jerry Butler
Don't Tell Your Mama (Where You've Been) : Eddie Floyd
Don't Touch Me : Bettye Swann
Don't Wake Me Up In The Morning, Michael : Peppermint Rainbow
Don't Waste My Time : John Mayall
Down On The Corner/Fortunate Son : Creedence Clearwater Revival
Early In The Morning : Vanity Fare
Earth Angel (Will You Be Mine) : The Vogues
Echo Park : Keith Barbour
Eleanor Rigby : Aretha Franklin
Electric Stories : The 4 Seasons Featuring the Sound of Frankie Valli
Eli's Coming : Three Dog Night
Eloise : Barry Ryan
Eternity : Vikki Carr
Everybody Knows Matilda : Duke Baxter
Everything I Do Gonh Be Funky (From Now On) : Lee Dorsey
Evil Woman Don't Play Your Games With Me : CROW
Fancy : Bobbie Gentry
Farewell Love Scene : Romeo & Juliet Soundtrack
Feeling Alright : Mongo Santamaria
Foolish Fool : Dee Dee Warwick
Fox On The Run : Manfred Mann
Friendship Train : Gladys Knight And The Pips
From Both Sides Now : Dion
Galveston : Roger Williams
Games People Play : Joe South
Get Back : The Beatles With Billy Preston
Get It From The Bottom : The Steelers
Get Off My Back Woman : B.B. King
Get Together : The Youngbloods
Getting The Corners : The T.S.U. Toronadoes
Gimme Gimme Good Lovin' : Crazy Elephant
Girls It Ain't Easy : The Honey Cone
God Knows I Love You : Nancy Sinatra
Goin' Out Of My Head/Forget To Remember : Frank Sinatra
Going In Circles : The Friends Of Distinction
Going Up The Country : Canned Heat
Goo Goo Barabajagal (Love Is Hot) : Donovan/Jeff Beck Group
Good Clean Fun : The Monkees
Good Morning Starshine : Strawberry Alarm Clock
Good Old Rock 'N Roll : Cat Mother & the All Night News Boys
Goodbye : Mary Hopkin
Goodbye Columbus : The Association
Great Balls Of Fire : Tiny Tim
Greensleeves : Mason Williams
Grits Ain't Groceries (All Around The World) : Little Milton
Groovin' (Out On Life) : The Newbeats
Groovy Grubworm : Harlow Wilcox and the Oakies
Guess Who : Ruby Winters
Hair : The Cowsills
Happy : Paul Anka
Happy Heart : Andy Williams
Hawaii Five-O : The Ventures
He Called Me Baby : Ella Washington
Heaven Knows : The Grass Roots
Hello It's Me : Nazz
Here I Go Again : Smokey Robinson & The Miracles
Hey There Lonely Girl : Eddie Holman
Hey! Baby : Jose Feliciano
Hold Me : The Baskerville Hounds
Holly Holy : Neil Diamond
Home To You : Earth Opera
Honky Tonk Women : The Rolling Stones
Hook And Sling-Part I : Eddie Bo
Hot Fun In The Summertime : Sly & The Family Stone
Hot Smoke & Sasafrass : The Bubble Puppy
Hurt So Bad : The Lettermen
I Can Hear Music : The Beach Boys
I Can't Get Next To You : The Temptations
I Can't Make It Alone : Lou Rawls
I Can't Say No To You : Betty Everett
I Can't Turn You Loose : The Chambers Brothers
I Could Never Be President : Johnnie Taylor
I Do : The Moments
I Do Love You : Billy Stewart
I Forgot To Be Your Lover : William Bell
I Got A Line On You : Spirit
I Guess The Lord Must Be In New York City : Nilsson
I Like What You're Doing (To Me) : Carla Thomas
I Love You : Otis Leavill
I Need You Now : Ronnie Dove
I Started Loving You Again : Al Martino
I Still Believe In Tomorrow : John & Anne Ryder
I Take A Lot Of Pride In What I Am : Dean Martin
I Want You Back : Jackson 5
I Want You To Know : The New Colony Six
I'd Rather Be An Old Man's Sweetheart (Than A Young Man's Fool) : Candi Staton
I'll Bet You : Funkadelic
I'll Hold Out My Hand : The Clique
I'll Never Fall In Love Again : Burt Bacharach
I'll Never Fall In Love Again : Tom Jones
I'm Free : The Who
I'm Gonna Hold On Long As I Can : The Marvelettes
I'm Gonna Make You Love Me : Diana Ross And The Supremes & The Temptations
I'm Gonna Make You Mine : Lou Christie
I'm Tired : Savoy Brown
I've Been Loving You Too Long : Ike & Tina Turner
I've Gotta Be Me : Sammy Davis Jr.
I've Lost Everything I've Ever Loved : David Ruffin
Ice Cream Song : The Dynamics
If I Only Had Time : Nick DeCaro
If It Wasn't For Bad Luck : Ray Charles & Jimmy Lewis
In A Moment : The Intrigues
In My Room : Sagittarius
In The Bad, Bad Old Days (Before You Loved Me) : The Foundations
In The Year 2525 : Zager & Evans
In-A-Gadda-Da-Vida : Iron Butterfly
Is It Because I'm Black : Syl Johnson
Is It Something You've Got : Tyrone Davis
Is That All There Is : Peggy Lee
Israelites : Desmond Dekker & The Aces
It's Getting Better : Mama Cass
It's My Thing (You Can't Tell Me Who To Sock It To) : Marva Whitney
Jam Up Jelly Tight : Tommy Roe
Je T'Aime...Moi Non Plus : Jane Birkin Serge Gainsbourg
Jealous Kind Of Fella : Garland Green
Jesus Is A Soul Man : Lawrence Reynolds
Jingo : Santana
Johnny One Time : Brenda Lee
Julia : Ramsey Lewis
July You're A Woman : Pat Boone
Kay : John Wesley Ryles, I
Keem-O-Sabe : The Electric Indian
Kick Out The Jams : MC5
Kool And The Gang : Kool & The Gang
Kozmic Blues : Janis Joplin
Kum Ba Yah : Tommy Leonetti
La La La (If I Had You) : Bobby Sherman
Lady-O : The Turtles
Leaving On A Jet Plane : Peter, Paul & Mary
Let A Woman Be A Woman - Let A Man Be A Man : Dyke And The Blazers
Let It Be Me : Glen Campbell & Bobbie Gentry
Let Me Be The Man My Daddy Was : The Chi-lites
Let Me Be The One : Peaches & Herb
Let Me Love You : Ray Charles
Let's Call It A Day Girl : Bobby Vee
Let's Dance : Ola & The Janglers
Let's Work Together (Part 1) : Wilbert Harrison
Life And Death In G & A : Abaco Dream
Little Arrows : Leapy Lee
Lo Mucho Que Te Quiero (The More I Love You) : Rene & Rene
Lodi : Al Wilson
Long Green : The Fireballs
Long Line Rider : Bobby Darin
Look At Mine : Petula Clark
Look-Ka Py Py : The Meters
Love (Can Make You Happy) : Mercy
Love Is All I Have To Give : The Checkmates, Ltd.
Love Is Just A Four-Letter Word : Joan Baez
Love Of The Common People : The Winstons
Love Theme From Romeo & Juliet : Henry Mancini And His Orchestra
Love Theme From Romeo And Juliet (A Time For Us) : Johnny Mathis
Love Will Find A Way : Jackie DeShannon
MacArthur Park : Waylon Jennings & The Kimberlys
Make Believe : Wind
Make Your Own Kind Of Music : Mama Cass Elliot
Malinda : Bobby Taylor & The Vancouvers
Maybe The Rain Will Fall : The Cascades
Maybe Tomorrow : The Iveys
Me About You : The Lovin' Spoonful
Memphis Train : Buddy Miles Express
Memphis Underground : Herbie Mann
Mendocino : Sir Douglas Quintet
Mercy : Ohio Express
Midnight : Dennis Yost And The Classics IV
Midnight Cowboy : Ferrante & Teicher
Mind, Body and Soul : The Flaming Ember
Moonflight : Vik Venus Alias: Your Main Moon Man
Morning Girl : The Neon Philharmonic
Move Over : Steppenwolf
Mr. Walker, It's All Over : Billie Jo Spears
Muddy Mississippi Line : Bobby Goldsboro
Muddy River : Johnny Rivers
My Balloon's Going Up : Archie Bell & The Drells
My Pledge Of Love : The Joe Jeffrey Group
My Wife, My Dog, My Cat : The Maskman & The Agents
MÃ¡h-NÃ¡-Mah-NÃ¡ : Piero Umiliani
Na Na Hey Hey Kiss Him Goodbye : Steam
Never Comes The Day : The Moody Blues
Never Gonna Let Him Know : Debbie Taylor
No Not Much : The Smoke Ring
No One For Me To Turn To : Spiral Starecase
Nobody But You Babe : Clarence Reid
Nothing But A Heartache : The Flirtations
Nothing Can Take The Place Of You : Brook Benton
Ob-La-Di, Ob-La-Da : Arthur Conley
Oh Happy Day : The Edwin Hawkins' Singers Featuring: Dorothy Combs Morrison
Oh How Happy : Blinky & Edwin Starr
Oh Me Oh My (I'm A Fool For You Baby) : Lulu
Okie From Muskogee : Merle Haggard And The Strangers
On Campus : Dickie Goodman
On The Dock Of The Bay : The Dells
One Night Affair : The O'Jays
One Tin Soldier : The Original Caste
Only You (And You Alone) : Bobby Hatfield
Out Of Sight, Out Of Mind : Little Anthony And The Imperials
Papa's Got A Brand New Bag : Otis Redding
People : The Tymes
Playgirl : Thee Prophets
Please Don't Desert Me Baby : Gloria Walker/Chevelles
Proud Mary : Solomon Burke
Proud Mary : The Checkmates, Ltd. featuring Sonny Charles
Quentin's Theme : The Charles Randolph Grean Sounde
Questions 67 And 68 : Chicago
Raindrops Keep Fallin' On My Head : B.J. Thomas
Ramblin' Gamblin' Man : Bob Seger System
Reconsider Me : Johnny Adams
Reuben James : Kenny Rogers & The First Edition
Rhythm Of The Rain : Gary Lewis And The Playboys
Riot : Hugh Masekela
River Deep-Mountain High : Deep Purple
Roosevelt And Ira Lee (Night of the Mossacin) : Tony Joe White
Runnin' Blue : The Doors
Sad Girl : The Intruders
San Francisco Is A Lonely Town : Joe Simon
Say You Love Me : The Impressions
Seattle : Perry Como
Shame, Shame : Magic Lanterns
She Belongs To Me : Rick Nelson
She Came In Through The Bathroom Window : Joe Cocker
She Lets Her Hair Down (Early In The Morning) : Gene Pitney
She Lets Her Hair Down (Early In The Morning) : The Tokens
She's A Lady : John Sebastian
She's Got Love : Thomas & Richard Frost
Shotgun : Vanilla Fudge
Shout! - Part 1 : Chambers Brothers
Simple Song Of Freedom : Tim Hardin
Since I Met You, Baby : Sonny James
Six White Horses : Tommy Cash
Slum Baby : Booker T. & The MG's
Smile A Little Smile For Me : The Flying Machine
So Good Together : Andy Kim
So I Can Love You : The Emotions
Someday We'll Be Together : Diana Ross & The Supremes
Something In The Air : Thunderclap Newman
Son Of A Lovin' Man : Buchanan Brothers
Son Of A Travelin' Man : Ed Ames
Sorry Suzanne : The Hollies
Soul Deep : The Box Tops
Soul Sister, Brown Sugar : Sam & Dave
Soulful Strut : Young-Holt Unlimited
Soulshake : Peggy Scott & Jo Jo Benson
St. Louis : The Easybeats
Sugar, Sugar : The Archies
Suite: Judy Blue Eyes : Crosby, Stills & Nash
Sunday Mornin' : Oliver
Suspicious Minds : Elvis Presley
Swingin' Tight : Bill Deal & The Rhondels
Switch It On : Cliff Nobles & Co.
Take A Letter Maria : R.B. Greaves
That's The Way God Planned It : Billy Preston
That's The Way Love Is : Marvin Gaye
The Beginning Of My End : The Unifics
The Boxer : Simon & Garfunkel
The Carroll County Accident : Porter Wagoner
The Colour Of My Love : Jefferson
The Girl I'll Never Know (Angels Never Fly This Low) : Frankie Valli
The Greatest Love : Dorsey Burnette
The Grooviest Girl In The World : The Fun And Games
The Letter : The Arbors
The Minotaur : Dick Hyman & His Electric Eclectics
The Pledge Of Allegiance : Red Skelton
The Sweeter He Is - Part I : The Soul Children
The Thought Of Loving You : The Crystal Mansion
The Tra La La Song (One Banana, Two Banana) : The Banana Splits
The Train : 1910 Fruitgum Co.
The Ways To Love A Man : Tammy Wynette
The Wedding Cake : Connie Francis
The Weight : Supremes & Temptations
Theme From Electric Surfboard : Brother Jack McDuff
There Never Was A Time : Jeannie C. Riley
These Eyes : Jr. Walker & The All Stars
Things I'd Like To Say : New Colony Six
This Girl Is A Woman Now : Gary Puckett And The Union Gap
This Old Heart Of Mine (Is Weak For You) : Tammi Terrell
Till You Get Enough : Watts 103rd Street Rhythm Band
Time Machine : Grand Funk Railroad
Time Of The Season : The Zombies
To Know You Is To Love You : Bobby Vinton
Tonight I'll Be Staying Here With You : Bob Dylan
Tonight I'll Say A Prayer : Eydie Gorme
Too Experienced : Eddie Lovette
Too Many Cooks (Spoil The Soup) : 100 Proof Aged in Soul
Traces : Classics IV Featuring Dennis Yost
Tracy : The Cuff Links
Truck Stop : Jerry Smith and his Pianos
Try A Little Kindness : Glen Campbell
Turn Around And Love You : Rita Coolidge
Turn! Turn! Turn!/To Everything There Is A Season : Judy Collins
Twenty-Five Miles : Edwin Starr
Undun : The Guess Who
Up On Cripple Creek : The Band
Vance : Roger Miller
Venus : The Shocking Blue
Volunteers : Jefferson Airplane
Voodoo Woman : Simon Stokes/Nighthawks
Walkin' In The Rain : Jay & The Americans
Was It Good To You : The Isley Brothers
We Gotta All Get Together : Paul Revere & The Raiders Featuring Mark Lindsay
We Love You, Call Collect : Art Linkletter
We Must Be In Love : Five Stairsteps & Cubie
We'll Cry Together : Maxine Brown
Wedding Bell Blues : The 5th Dimension
Welcome Me Love : The Brooklyn Bridge Featuring Johnny Maestro
What You Gave Me : Marvin Gaye & Tammi Terrell
When I Die : Motherlode
Where Do I Go/Be-In/Hare Krishna : The Happenings
Where Do You Go To (My Lovely) : Peter Sarstedt
White Houses : Eric Burdon & The Animals
Who Do You Love : Quicksilver Messenger Service
Whole Lotta Love : Led Zeppelin
Wichita Lineman : Sergio Mendes & Brasil '66
Will You Be Staying After Sunday : The Peppermint Rainbow
Winter World Of Love : Engelbert Humperdinck
Witchi Tai To : Everything Is Everything
Without Her : Herb Alpert
Wonderful : Blackwell
Wonderful World, Beautiful People : Jimmy Cliff
Yester-Me, Yester-You, Yesterday : Stevie Wonder
Yesterday, When I Was Young : Roy Clark
You Got To Pay The Price : Gloria Taylor
You Got Yours And I'll Get Mine : The Delfonics
You Keep Me Hanging On : Wilson Pickett
You Made A Believer (Out Of Me) : Ruby Andrews
You'll Never Walk Alone : The Brooklyn Bridge
You've Got The Power : The Esquires
You've Lost That Lovin' Feeling : Dionne Warwick
You, I : The Rugbys
Your Husband - My Wife : Brooklyn Bridge
Zazueira (Za-zoo-wher-a) : Herb Alpert & The Tijuana Brass
