(I Don't Want To Love You But) You Got Me Anyway : Sutherland Brothers And Quiver
A Letter To Myself : The Chi-lites
A Passion Play (Edit #8) : Jethro Tull
A Song I'd Like To Sing : Kris Kristofferson & Rita Coolidge
Abra-Ca-Dabra : The De Franco Family
Ain't Got No Home : The Band
Ain't No Woman (Like The One I've Got) : Four Tops
All I Know : Garfunkel
Also Sprach Zarathustra (2001) : Deodato
And I Love You So : Perry Como
Angie : The Rolling Stones
Anthem : Wayne Newton
Armed And Extremely Dangerous : First Choice
As Time Goes By : Nilsson
Aubrey : Bread
Avenging Annie : Andy Pratt
Baby Come Close : Smokey Robinson
Back For A Taste Of Your Love : Syl Johnson
Back When My Hair Was Short : Gunhill Road
Bad Weather : The Supremes
Basketball Jones Featuring Tyrone Shoelaces : Cheech & Chong
Be : Neil Diamond
Bell Bottom Blues : Eric Clapton
Big City Miss Ruth Ann : Gallery
Bitter Bad : Melanie
Black Byrd : Donald Byrd
Blood Red And Goin' Down : Tanya Tucker
Blue Collar : Bachman-Turner Overdrive
Bongo Rock : The Incredible Bongo Band
Boo, Boo, Don't 'Cha Be Blue : Tommy James
Boogie Woogie Man : Paul Davis
Break Up To Make Up : The Stylistics
Breaking Up Somebody's Home : Albert King
Brother Louie : Stories
Brother's Gonna Work It Out : Willie Hutch
But I Do : Bobby Vinton
California Saga (On My Way To Sunny Californ-i-a) : The Beach Boys
Check It Out : Tavares
Choo Choo Mama : Ten Years After
Cindy Incidentally : Faces
Clair : Gilbert O'Sullivan
Come Live With Me : Ray Charles
Come Live With Me : Roy Clark
Come Softly To Me : The New Seekers
Control Of Me : Les Emmerson
Cook With Honey : Judy Collins
CorazÃ³n : Carole King
Cosmic Sea : The Mystic Moods
Could It Be I'm Falling In Love : The Spinners
Could You Ever Love Me Again : Gary & Dave
Country Sunshine : Dottie West
Crocodile Rock : Elton John
Cum On Feel The Noize : Slade
D'yer Mak'er : Led Zeppelin
Daddy's Home : Jermaine Jackson
Daisy A Day : Jud Strunk
Dancing In The Moonlight : King Harvest
Dancing To Your Music : Archie Bell & The Drells
Danny's Song : Anne Murray
Daytime Night-Time : Keith Hampshire
Dead Skunk : Loudon Wainwright III
Delta Queen : Don Fardon
Do It Again : Steely Dan
Do It In The Name Of Love : Candi Staton
Do You Want To Dance? : Bette Midler
Doing It To Death : Fred Wesley & The J.B's
Don't Burn Me : Paul Kelly
Don't Cross The River : America
Don't Expect Me To Be Your Friend : Lobo
Don't Leave Me Starvin' For Your Love (Part 1) : Holland-Dozier
Don't Let It End ('Til You Let It Begin) : The Miracles
Don't Let It Get You Down : The Crusaders
Don't Let Me Be Lonely Tonight : James Taylor
Dream On : Aerosmith
Dreidel : Don McLean
Drinking Wine Spo-dee O'dee : Jerry Lee Lewis
Dueling Banjos : Deliverance/Eric Weissberg & Steve Mandell
Dueling Tubas : Martin Mull and Orchestra
Ecstasy : Ohio Players
Everybody's Had The Blues : Merle Haggard And The Strangers
Evil : Earth, Wind & Fire
Fencewalk : Mandrill
Fever/My Crew : Rita Coolidge
Finder's Keepers : Chairman Of The Board
Follow Your Daughter Home : The Guess Who
Fool Like You : Tim Moore
Free Ride : Edgar Winter Group
Freedom For The Stallion : The Hues Corporation
Friend And A Lover : The Partridge Family Starring Shirley Jones Featuring David Cassidy
Funky Stuff : Kool & The Gang
Funny Face : Donna Fargo
Get It Together : Jackson 5
Give It To Me : The J. Geils Band
Give Me Love - (Give Me Peace On Earth) : George Harrison
Give Me Your Love : Barbara Mason
Giving It All Away : Roger Daltrey
Good Morning : Michael Redway
Good Morning Heartache : Diana Ross
Gotta Find A Way : Moments
Half-Breed : Cher
Happy : Bobby Darin
Harry Hippie : Bobby Womack & Peace
Having A Party medley : The Ovations
He : Today's People
Heartbeat - It's A Lovebeat : The DeFranco Family featuring Tony DeFranco
Hello Hurray : Alice Cooper
Hello It's Me : Todd Rundgren
Hello Stranger : Fire And Rain
Hey Girl (i Like Your Style) : The Temptations
Hey You! Get Off My Mountain : The Dramatics
Hey, Little Girl : Foster Sylvers
Hi, Hi, Hi : Wings
Hocus Pocus : Focus
Hot Wire : Al Green
How Can I Tell You : Travis Wammack
Hummingbird : Seals & Crofts
Hurts So Good : Millie Jackson
I Believe In You (You Believe In Me) : Johnnie Taylor
I Can Understand It : The New Birth
I Can't Stand The Rain : Ann Peebles
I Can't Stand To See You Cry : Smokey Robinson & The Miracles
I Don't Know What It Is, But It Sure Is Funky : Ripple
I Don't Want To Make You Wait : The Delfonics
I Got Ants In My Pants (and i want to dance) (Part 1) : James Brown
I Knew Jesus (Before He Was A Star) : Glen Campbell
I Like You : Donovan
I Love : Tom T. Hall
I Never Said Goodbye : Engelbert Humperdinck
I Was Checkin' Out She Was Checkin' In : Don Covay
I Won't Last A Day Without You : Maureen McGovern
I' Been Watchin' You : The South Side Movement
I'll Always Love My Mama (Part I) : The Intruders
I'll Be Your Shelter (In Time Of Storm) : Luther Ingram
I'm A Stranger Here : Five Man Electrical Band
I'm Coming Home : Johnny Mathis
I'm Just A Singer (In A Rock And Roll Band) : The Moody Blues
I'm Never Gonna Be Alone Anymore : Cornelius Brothers & Sister Rose
I'm Sorry : Joey Heatherton
I've Got So Much To Give : Barry White
If I Could Only Be Sure : Nolan Porter
If We Make It Through December : Merle Haggard
If You Want Me To Stay : Sly & The Family Stone
If You're Ready (Come Go With Me) : The Staple Singers
In Heaven There Is No Beer : Clean Living
In The Midnight Hour : Cross Country
Isn't It About Time : Stephen Stills-Manassas
It May Be Winter Outside, (But In My Heart It's Spring) : Love Unlimited
It's Forever : The Ebonys
Jambalaya (On The Bayou) : The Blue Ridge Rangers
Jesus Is Just Alright : The Doobie Brothers
Jim Dandy : Black Oak Arkansas
Jimmy Loves Mary-Anne : Looking Glass
Joy Pt. I : Isaac Hayes
Just You 'n' Me : Chicago
Keep On Singing : Austin Roberts
Keep On Truckin' (Part 1) : Eddie Kendricks
Kids Say The Darndest Things : Tammy Wynette
Killing Me Softly With His Song : Roberta Flack
Kissing My Love : Bill Withers
Knockin' On Heaven's Door : Bob Dylan
Kodachrome : Paul Simon
Kufanya Mapenzi (Making Love) : Ramsey Lewis
L.a. Freeway : Jerry Jeff Walker
Last Kiss : J. Frank Wilson and The Cavaliers
Last Kiss : Wednesday
Last Song : Edward Bear
Last Tango In Paris : Herb Alpert & The Tijuana Brass
Leaving Me : The Independents
Let Me Be There : Olivia Newton-John
Let Me Be Your Lovemaker : Betty Wright
Let Me In : The Osmonds
Let Me Try Again (Laisse Moi Le Temps) : Frank Sinatra
Letter To Lucille : Tom Jones
Little Willy : The Sweet
Living Together, Growing Together : The 5th Dimension
Lord, Mr. Ford : Jerry Reed
Lost Horizon : Shawn Phillips
Love And Happiness : Earnest Jackson
Love Has No Pride : Linda Ronstadt
Love Is What You Make It : The Grass Roots
Love Jones : Brighter Side Of Darkness
Love Music : The Raiders
Love Train : The O'Jays
Love's Theme : Love Unlimited Orchestra
Love, Love, Love : Donny Hathaway
Love, Reign O'er Me : The Who
Loves Me Like A Rock : Paul Simon (with The Dixie Hummingbirds)
Loving Arms : Dobie Gray
Lucky Man : Emerson, Lake & Palmer
MIND GAMES : John Lennon
Magic Woman Touch : The Hollies
Make Me Twice The Man : New York City
Mama Was A Rock And Roll Singer, Papa Used To Write All Her Songs Part 1 : Sonny & Cher
Master Of Eyes (The Deepness Of Your Eyes) : Aretha Franklin
Me And Mrs. Jones : Billy Paul
Midnight Rider : Gregg Allman
Money : Pink Floyd
Monster Mash : Bobby Boris Pickett And The Crypt-Kickers
Mother-in-law : Clarence Carter
Mr. Skin : Spirit
Music Everywhere : Tufano & Giammarese
My Love : Paul McCartney & Wings
My Maria : B.W. Stevenson
My Pretending Days Are Over : The Dells
Names, Tags, Numbers & Labels : The Association
Neither One Of Us (Wants To Be The First To Say Goodbye) : Gladys Knight And The Pips
Never Let You Go : Bloodstone
Never, Never, Never (Grande, Grande, Grande) : Shirley Bassey
No : Bulldog
Nobody Wants You When You're Down And Out : Bobby Womack
Nobody Wins : Brenda Lee
Nutbush City Limits : Ike & Tina Turner
Oh No, Not My Baby : Merry Clayton
Oh! No Not My Baby : Rod Stewart
Oh, Babe, What Would You Say? : Hurricane Smith
On And Off (Part 1) : Anacostia
One Less Set Of Footsteps : Jim Croce
One Man Band (Plays All Alone) : Ronnie Dyson
One Of The Boys : Mott The Hoople
One Tin Soldier (The Legend of Billy Jack) : Coven
Only Love : Bill Quateman
Outlaw Man : David Blue
Painted Ladies : Ian Thomas
Palace Guard : Rick Nelson and The Stone Canyon Band
Paper Roses : Marie Osmond
Pardon Me Sir : Joe Cocker
Parrty - Part I : Maceo And The Macks
Peaceful : Helen Reddy
Peaceful Easy Feeling : Eagles
Photograph : Ringo Starr
Pieces Of April : Three Dog Night
Pillow Talk : Sylvia
Playground In My Mind : Clint Holmes
Pretty Lady : Lighthouse
Queen Of The Roller Derby : Leon Russell
Ramblin Man : The Allman Brothers Band
Redneck Friend : Jackson Browne
Reelin' & Rockin' : Chuck Berry
Ridin' My Thumb To Mexico : Johnny Rodriguez
River : Joe Simon
River Road : Uncle Dog
Rock 'N Roll (I Gave You The Best Years of My Life) : Kevin Johnson
Rock On : David Essex
Rockin' Pneumonia - Boogie Woogie Flu : Johnny Rivers
Rocky Mountain High : John Denver
Rocky Mountain Way : Joe Walsh
Roll In My Sweet Baby's Arms/I'm So Lonesome I Could Cry : Hank Wilson
Roll Over Beethoven : Electric Light Orchestra
Rosalie : Sam Neely
Rosanna : Dennis Yost And The Classics IV
Rubber Bullets : 10cc
Sail Around The World : David Gates
Satin Sheets : Jeanne Pruett
Saw A New Morning : Bee Gees
Say, Has Anybody Seen My Sweet Gypsy Rose : Dawn Featuring Tony Orlando
Separate Ways : Elvis Presley
Show And Tell : Al Wilson
Silly Wasn't I : Valerie Simpson
Sister James : Nino Tempo & 5th Ave. Sax
Slippin' Away : Jean Shepard
Slow Motion (Part 1) : Johnny Williams
Smoke Gets In Your Eyes : Blue Haze
Smoke! Smoke! Smoke! (That Cigarette) : Commander Cody
Smokin' In The Boy's Room : Brownsville Station
Some Guys Have All The Luck : The Persuaders
Somebody Loves You : The Whispers
Songman : Cashman & West
Soul Je T'aime : Sylvia And Ralfi Pagan
Soul Makossa : Afrique
Soul Makossa : Manu Dibango
Soul Song : Joe Stampley
Space Oddity : David Bowie
Space Race : Billy Preston
Stealin' : Uriah Heep
Stir It Up : Johnny Nash
Stop, Wait & Listen : Circus
Stuck In The Middle With You : Stealers Wheel
Such A Night : Dr. John
Sugar Magnolia : Grateful Dead
Summer (The First Time) : Bobby Goldsboro
Sunshine : Mickey Newbury
Super Fly Meets Shaft : John & Ernest
Superfly : Curtis Mayfield
Superstition : Stevie Wonder
Swamp Witch : Jim Stafford
Sweet Charlie Babe : Jackie Moore
Take A Closer Look At The Woman You're With : Wilson Pickett
Teddy Bear Song : Barbara Fairchild
Tell Her She's Lovely : El Chicano
That Lady (Part 1) : The Isley Brothers
That's Why You Remember : Kenny Karen
The Cover Of Rolling Stone : Dr. Hook And The Medicine Show
The Free Electric Band : Albert Hammond
The Hurt : Cat Stevens
The Joker : The Steve Miller Band
The Lord Knows I'm Drinking : Cal Smith
The Message : Cymande
The Most Beautiful Girl : Charlie Rich
The Night The Lights Went Out In Georgia : Vicki Lawrence
The Way We Were : Barbra Streisand
The Whole Town's Laughing At Me : Teddy Pendergrass
The World Is A Ghetto : War
Theme From Cleopatra Jones : Joe Simon featuring The Mainstreeters
There You Go : Edwin Starr
They're Coming To Take Me Away, Ha-Haaa! : Napoleon XIV
Thinking Of You : Loggins & Messina
This Is Your Song : Don Goodwin
This Time I'm Gone For Good : Bobby Blue Bland
This Time It's Real : Tower Of Power
To Know You Is To Love You : B.B. King
Today I Started Loving You Again : Bettye Swann
Tonight : Raspberries
Top Of The World : Carpenters
Top Of The World : Lynn Anderson
Tossin' And Turnin' : Bunny Sigler
Trouble Man : Marvin Gaye
Trying To Hold On To My Woman : Lamont Dozier
Tweedlee Dee : Little Jimmy Osmond
Uneasy Rider : Charlie Daniels
Vado Via : Drupi
Walk On The Wild Side : Lou Reed
Watergrate : Dickie Goodman
We're An American Band : Grand Funk
We're Gonna Have A Good Time : Rare Earth
West Coast Woman : Painter
What A Shame : Foghat
What My Baby Needs Now Is A Little More Lovin' : James Brown-Lyn Collins
When I Fall In Love/Are You Lonesome Tonight : Donny Osmond
Who's In The Strawberry Patch With Sally : Tony Orlando & Dawn
Why Can't We Live Together : Timmy Thomas
Why Me : Kris Kristofferson
Wildflower : Skylark
Wish That I Could Talk To You : The Sylvers
With A Child's Heart : Michael Jackson
Without You In My Life : Tyrone Davis
Woman From Tokyo : Deep Purple
Woman To Woman : Joe Cocker and The Chris Stainton Band
Working Class Hero : Tommy Roe
Yes We Can Can : The Pointer Sisters
Yesterday I Had The Blues : Harold Melvin And The Blue Notes
You Can Do Magic : Limmie & Family Cookin'
You Turn Me On, I'm A Radio : Joni Mitchell
You'd Better Believe It : The Manhattans
You're A Lady : Peter Skellern
You're A Special Part Of Me : Diana Ross & Marvin Gaye
You're So Vain : Carly Simon
You're The Best Thing That Ever Happened To Me : Ray Price
You've Got To Take It (If You Want It) : The Main Ingredient
You've Never Been This Far Before : Conway Twitty
Your Mama Don't Dance : Kenny Loggins & Jim Messina
Your Side Of The Bed : Mac Davis
