#9 Dream : John Lennon
(All I Have To Do Is) Dream : The Nitty Gritty Dirt Band
(Call Me Your) Anything Man : Bobby Moore
(How I Spent My Summer Vacation) Or A Day At The Beach With Pedro & Man - P : Cheech & Chong
(I Believe) There's Nothing Stronger Than Our Love : Paul Anka/Odia Coates
(I'm Going By) The Stars In Your Eyes : Ron Banks And The Dramatics
(Just Like) Romeo And Juliet : Sha Na Na
(if You Add) All The Love In The World : Mac Davis
50 Ways To Leave Your Lover : Paul Simon
7-6-5-4-3-2-1 (Blow Your Whistle) : Gary Toms Empire
99 Miles From L.a. : Albert Hammond
A Friend Of Mine Is Going Blind : John Dawson Read
Action Speaks Louder Than Words : Chocolate Milk
Ain't No Way To Treat A Lady : Helen Reddy
Ain't That Peculiar : Diamond Reo
All By Myself : Eric Carmen
All Right Now : Lea Roberts
Alvin Stone (The Birth & Death Of A Gangster) : Fantastic Four
Amie : Pure Prairie League
Angel (What In The World's Come Over Us) : Atlanta Rhythm Section
Are You Sure Hank Done It This Way : Waylon Jennings
Art For Art's Sake : 10cc
As Long As He Takes Care Of Home : Candi Staton
Astral Man : Nektar
At Seventeen : Janis Ian
Attitude Dancing : Carly Simon
Autobahn : Kraftwerk
Baby Face : The Wing And A Prayer Fife & Drum Corps.
Baby, Hang Up The Phone : Carl Graves
Baby-Get It On : Ike & Tina Turner
Bad Blood : Neil Sedaka
Ballroom Blitz : Sweet
Beer Barrel Polka/Dick And Jane : Bobby Vinton
Better By The Pound : Funkadelic
Big Yellow Taxi : Joni Mitchell
Black Friday : Steely Dan
Black Superman - Muhammad Ali : Johnny Wakelin & The Kinshasa Band
Black Water : The Doobie Brothers
Blanket On The Ground : Billie Jo Spears
Bloody Well Right : Supertramp
Blue Eyes Crying In The Rain : Willie Nelson
Boogie On Reggae Woman : Stevie Wonder
Born To Run : Bruce Springsteen
Brand New Love Affair (Part I & II) : Chicago
Brazil : The Ritchie Family
Breakfast For Two : Country Joe McDonald
Bump Me Baby Part 1 : Dooley Silverspoon
Bungle In The Jungle : Jethro Tull
Butter Boy : Fanny
Bye Bye Baby : U.S. 1
Can't Get It Out Of My Head : Electric Light Orchestra
Caribbean Festival : Kool & The Gang
Carolina In The Pines : Michael Murphey
Carry Me : David Crosby/Graham Nash
Change With The Times : Van Mccoy
Charmer : Tim Moore
Chase The Clouds Away : Chuck Mangione
Check It Out : Bobby Womack
Chevy Van : Sammy Johns
Chico And The Man : Jose Feliciano
Chinese Kung Fu : Banzaii
Chocolate Chip : Isaac Hayes
Chocolate City : Parliament
Come And Get Your Love : Roger Daltrey
Costafine Town : Splinter
Could It Be Magic : Barry Manilow
Crazy Talk : Chilliwack
Cry To Me : Loleatta Holloway
Daisy Jane : America
Damn It All : Gene Cotton
Dance The Kung Fu : Carl Douglas
Dance With Me : Orleans
Dancin' Fool : The Guess Who
Dear Prudence : Katfish
Department Of Youth : Alice Cooper
Devil In The Bottle : T.G. Sheppard
Diamonds And Rust : Joan Baez
Do It Any Way You Wanna : Peoples Choice
Doctor's Orders : Carol Douglas
Don't Call Us, We'll Call You : Sugarloaf/Jerry Corbetta
Don't Cry Joni : Conway Twitty with Joni Lee
Don't It Make You Wanna Dance? : Rusty Wier
Don't Let Go : Commander Cody
Don't Take Your Love : The Manhattans
Don't Tell Me Goodnight : Lobo
Dream Merchant : New Birth
Dreaming A Dream : Crown Heights Affair
Dynomite-Part I : Tony Camillo's Bazuka
Ease On Down The Road : Consumer Rapport
Easy Evil : Travis Wammack
Eighteen With A Bullet : Pete Wingfield
El Bimbo : Bimbo Jet
Emma : Hot Chocolate
Every Day I Have To Cry Some : Arthur Alexander
Everybody Wants To Find A Bluebird : Randy Edelman
Fallin' In Love : Hamilton, Joe Frank & Reynolds
Fame : David Bowie
Fancy Lady : Billy Preston
Feel Like Makin' Love : Bad Company
Feelin' That Glow : Roberta Flack
Feelings : Morris Albert
Fight The Power Part 1 : The Isley Brothers
Fire On The Mountain : The Marshall Tucker Band
Fly, Robin, Fly : Silver Convention
Foot Stompin Music : Hamilton Bohannon
For A Dancer : Prelude
For Your Love : Christopher Paul And Shawn
Free Bird : Lynyrd Skynyrd
Free Man : South Shore Commission
From His Woman To You : Barbara Mason
Funny How Love Can Be : First Class
Future Shock : Hello People
Gee Baby : Peter Shelley
Get Dancin' : Disco Tex & The Sex-O-Lettes
Get Down Tonight : KC And The Sunshine Band
Get Down, Get Down (Get On The Floor) : Joe Simon
Give It What You Got/Peace Pipe : B.T. Express
Glasshouse : The Temptations
Gone At Last : Paul Simon/Phoebe Snow
Good Times, Rock & Roll : Flash Cadillac And The Continental Kids
Got To Get You Into My Life : Blood, Sweat & Tears
Growin' : Loggins & Messina
Hang On Sloopy : Rick Derringer
Heartbreak Road : Bill Withers
Heat Wave/love Is A Rose : Linda Ronstadt
Help Me Make It (To My Rockin' Chair) : B.J. Thomas
Help Me Rhonda : Johnny Rivers
Hey There Little Firefly Part I : Firefly
Hijack : Herbie Mann
Hollywood Hot : The Eleventh Hour
Honey Trippin' : The Mystic Moods
Hope That We Can Be Together Soon : Sharon Paige and Harold Melvin And The Blue Notes
Hoppy, Gene And Me : Roy Rogers
How Glad I Am : Kiki Dee
How High The Moon : Gloria Gaynor
How Long (Betcha' Got A Chick On The Side) : The Pointer Sisters
Hurricane (Part I) : Bob Dylan
Hush/I'm Alive : Blue Swede
I Am Love (Parts I & II) : Jackson 5
I Believe I'm Gonna Love You : Frank Sinatra
I Believe In Father Christmas : Greg Lake
I Belong To You : Love Unlimited
I Don't Know Why : The Rolling Stones
I Don't Like To Sleep Alone : Paul Anka with Odia Coates
I Don't Want To Be A Lone Ranger : Johnny Guitar Watson
I Dreamed Last Night : Justin Hayward & John Lodge
I Fought The Law : Sam Neely
I Get High On You : Sly Stone
I Get Lifted : George McCrae
I Go To Pieces : Cotton, Lloyd & Christian
I Got Stoned And I Missed It : Jim Stafford
I Have A Dream : Donny Osmond
I Just Can't Say Goodbye : Philly Devotions
I Love Makin' Love To You : Evie Sands
I Love Music (Part 1) : The O'Jays
I Only Have Eyes For You : Art Garfunkel
I Wanna Learn A Love Song : Harry Chapin
I Want'a Do Something Freaky To You : Leon Haywood
I Won't Last A Day Without You/Let Me Be The One : Al Wilson
I Wouldn't Treat A Dog (The Way You Treated Me) : Bobby Bland
I'll Be Holding On : Al Downing
I'll Go To My Grave Loving You : The Statler Brothers
I'll Play For You : Seals & Crofts
I'll Still Love You : Jim Weatherly
I'm A Woman : Maria Muldaur
I'm Her Fool : Billy Swan
I'm On Fire : 5000 Volts
I'm On Fire : Dwight Twilley Band
I'm On Fire : Jim Gilstrap
I'm Sorry : John Denver
I've Been This Way Before : Neil Diamond
I've Got The Music In Me : The Kiki Dee Band
If I Could Only Win Your Love : Emmylou Harris
If I Ever Lose This Heaven : AWB
If You Think You Know How To Love Me : Smokey
Is It Love That We're Missin' : Quincy Jones (feat. The Brothers Johnson)
Isn't It Lonely Together : Stark & McBrien
It Do Feel Good : Donna Fargo
It Only Takes A Minute : Tavares
It's All Right : Jim Capaldi
Jackie Blue : Ozark Mountain Daredevils
Judy Mae : Boomer Castleman
Junior's Farm/Sally G : Paul McCartney & Wings
Just Too Many People : Melissa Manchester
KILLER QUEEN : Queen
Katmandu : Bob Seger
Keep On Tryin' : Poco
Keep Your Eye On The Sparrow : Merry Clayton
L-O-V-E (Love) : Al Green
Lady : Styx
Lady Blue : Leon Russell
Lady Marmalade : Labelle
Leftovers : Millie Jackson
Leona : Wet Willie
Let Me Start Tonite : Lamont Dozier
Let's Do It Again : The Staple Singers
Let's Live Together : The Road Apples
Let's Straighten It Out : Latimore
Letting Go : Wings
Life And Death In G&A : Love Childs Afro Cuban Blues Band
Like A Sunday Morning : Lana Cantrell
Like They Say In L.A. : East L.A. Car Pool
Linda On My Mind : Conway Twitty
Living For The City : Ray Charles
Lizzie And The Rainman : Tanya Tucker
Lonely School Year : The Hudson Brothers
Long Tall Glasses (I Can Dance) : Leo Sayer
Look At Me (I'm In Love) : Moments
Love Corporation : The Hues Corporation
Love Don't You Go Through No Changes On Me : Sister Sledge
Love Hurts : Nazareth
Love Is The Drug : Roxy Music
Love Machine (Part 1) : The Miracles
Love Power : Willie Hutch
Love To Love You Baby : Donna Summer
Love Won't Let Me Wait : Major Harris
Lovin' You : Minnie Riperton
Low Rider : War
Lucy In The Sky With Diamonds : Elton John
Lyin' Eyes : Eagles
Machines : John Livigni
Magic : Pilot
Main Title (Theme From Jaws) : John Williams/Jaws Soundtrack
Mamacita : The Grass Roots
Manhattan Spiritual : Mike Post
Mexico : James Taylor
Minnesota : Northern Light
Miracles : Jefferson Starship
Mister Magic : Grover Washington, Jr.
Misty : Ray Stevens
Money : Gladys Knight And The Pips
Morning Side Of The Mountain : Donny & Marie Osmond
Mr. D.J. (5 For The D.J.) : Aretha Franklin
Mr. Jaws : Dickie Goodman
Ms. Grace : The Tymes
Must Of Got Lost : The J. Geils Band
My Boy : Elvis Presley
My Elusive Dreams : Charlie Rich
My Eyes Adored You : Frankie Valli
My First Day Without Her : Dennis Yost And The Classics IV
My Little Lady : Bloodstone
My Little Town : Simon & Garfunkel
Never Been Any Reason : Head East
Never Let Her Go : David Gates
Nevertheless/Louisiana Lou And Three Card Monty John : The Allman Brothers Band
Nice, Nice, Very Nice : Ambrosia
Nightingale : Carole King
Nights On Broadway : Bee Gees
No Charge : Shirley Caesar
No No Song/snookeroo : Ringo Starr
Nothin' Heavy : David Bellamy
Once You Get Started : Rufus Featuring Chaka Khan
One Beautiful Day : Ecstasy, Passion & Pain
One More Tomorrow : Henry Gross
Only One Woman : Nigel Olsson
Only You Can : Fox
Operator : The Manhattan Transfer
Our Last Song Together : Bo Donaldson And The Heywoods
Over My Head : Fleetwood Mac
Paloma Blanca : George Baker Selection
Part Of The Plan : Dan Fogelberg
Party Music : Pat Lundi
Philadelphia : B.B. King
Philadelphia Freedom : The Elton John Band
Pinball : Brian Protheroe
Please Tell Him That I Said Hello : Debbie Campbell
Please, Mr. President : Paula Webb
Poetry Man : Phoebe Snow
Rainy Day People : Gordon Lightfoot
Real Man : Todd Rundgren
Reality : James Brown
Reconsider Me : Narvel Felts
Remember The Rain? : The 21st Century
Rhinestone Cowboy : Glen Campbell
Ride 'em Cowboy : Paul Davis
Rock & Roll Runaway : Ace
Rock And Roll All Nite (live) : Kiss
Rockin' All Over The World : John Fogerty
Rockin' And Rollin' On The Streets Of Hollywood : Buddy Miles
Rockin' Chair : Gwen McCrae
Rocky : Austin Roberts
Roll On Down The Highway : Bachman-Turner Overdrive
Rolling Down A Mountainside : The Main Ingredient
Ruby, Baby : Billy Crash Craddock
Run Joey Run : David Geddes
Run Tell The People : Daniel Boone
Runaway : Charlie Kulis
S.O.S. : ABBA
Sad Sweet Dreamer : Sweet Sensation
Sail On Sailor : The Beach Boys
Sailing : Rod Stewart
Salsoul Hustle : The Salsoul Orchestra
Sandy : The Hollies
Satin Soul : Love Unlimited Orchestra
Saturday Night : Bay City Rollers
Send In The Clowns : Judy Collins
Shame, Shame, Shame : Shirley And Company
Shaving Cream : Benny Bell
Shoes : Reparata
Shoeshine Boy : Eddie Kendricks
Shotgun Shuffle : The Sunshine Band
Showdown : Odia Coates
Sky High : Jigsaw
Slippery When Wet : Commodores
Slow Ride : Foghat
Smokin' Room : Carl Carlton
Sneakin' Up Behind You : The Brecker Brothers
Sneaky Snake : Tom T. Hall
So In Love : Curtis Mayfield
Solitaire : Carpenters
Some Kind Of Wonderful : Grand Funk
Something Better To Do : Olivia Newton-John
Sooner Or Later : The Impressions
Soul Train 75 : Soul Train Gang
Spider Jiving : Andy Fairweather Low
Squeeze Box : The Who
Star On A TV Show : The Stylistics
Sugar Pie Guy Pt. 1 : The Joneses
Summer Of '42 : Biddu Orchestra
Sun Goddess : Ramsey Lewis and Earth, Wind & Fire
Sunday Sunrise : Anne Murray
Supernatural Thing - Part I : Ben E. King
Sure Feels Good : Elvin Bishop
Sweet Emotion : Aerosmith
Sweet Sticky Thing : Ohio Players
Take Me To The River : Syl Johnson
Thanks For The Smiles : Charlie Ross
That's The Way Of The World : Earth, Wind & Fire
The Agony And The Ecstasy : Smokey Robinson
The Bertha Butt Boogie-Part 1 : The Jimmy Castor Bunch
The Biggest Parakeets In Town : Jud Strunk
The Blind Man In The Bleachers : Kenny Starr
The Entertainer : Billy Joel
The Funky Gibbon : The Goodies
The Homecoming : Hagood Hardy
The Hustle : Van McCoy The Soul City Symphony
The Last Farewell : Roger Whittaker
The Millionaire : Dr. Hook
The Music Never Stopped : The Grateful Dead
The Other Woman : Vicki Lawrence
The Pill : Loretta Lynn
The Proud One : The Osmonds
The South's Gonna Do It : The Charlie Daniels Band
The Way I Want To Touch You : Captain & Tennille
The White Knight : Cledus Maggard And The Citizen's Band
The Zip : Mfsb
Theme From Mahogany (Do You Know Where You're Going To) : Diana Ross
Theme From S.W.A.T. : Rhythm Heritage
There Goes Another Love Song : The Outlaws
They Just Can't Stop It the (Games People Play) : The Spinners
Third Rate Romance : Amazing Rhythm Aces
This Old Man : Purple Reign
This Will Be : Natalie Cole
Three Steps From True Love : The Reflections
Til The World Ends : Three Dog Night
Times Of Your Life : Paul Anka
To Each His Own : Faith, Hope And Charity
To The Door Of The Sun (Alle Porte Del Sole) : Al Martino
Toby/that's How Long : The Chi-lites
Top Of The World (Make My Reservation) : Canyon
Touch Me Baby (reaching Out For Your Love) : Tamiko Jones
Trampled Under Foot : Led Zeppelin
Turn Back The Pages : Stephen Stills
Turn To Stone : Joe Walsh
Tush : ZZ Top
Two Fine People : Cat Stevens
Up In A Puff Of Smoke : Polly Brown
Wake Up Everybody (Part 1) : Harold Melvin And The Blue Notes
Walk Away From Love : David Ruffin
Walking In Rhythm : The Blackbyrds
Wasted Days And Wasted Nights : Freddy Fender
We All Gotta Stick Together : Four Tops
We Been Singin' Songs : Baron Stewart
We May Never Love Like This Again : Maureen McGovern
We're Almost There : Michael Jackson
What A Diff'rence A Day Makes : Esther Phillips
What A Man, My Man Is : Lynn Anderson
What Am I Gonna Do With You : Barry White
What Time Of Day : Billy Thunderkloud & The Chieftones
What You Got : Duke & The Drivers
Whatever Gets You Thru The Night : John Lennon With The Plastic Ono Nuclear Band
When A Child Is Born : Michael Holm
When Will I See You Again : The Three Degrees
When You're Young And In Love : Ralph Carter
When You're Young And In Love : The Choice Four
Where Have They Gone : Jimmy Beaumont And The Skyliners
Where Is The Love : Betty Wright
Who Loves You : The 4 Seasons
Who's Sorry Now : Marie Osmond
Wolf Creek Pass : C.W. McCall
Woman To Woman : Shirley Brown
Wonderful Baby : Don McLean
Words (are Impossible) : Margie Joseph
Yesterday's Hero : John Paul Young
You : George Harrison
You Ain't Never Been Loved (Like I'm Gonna Love You) : Jessi Colter
You And Your Baby Blues : Solomon Burke
You Are A Song : Batdorf & Rodney
You Are So Beautiful/It's A Sin When You Love Somebody : Joe Cocker
You're A Part Of Me : Susan Jacks
You're All I Need To Get By : Tony Orlando & Dawn
Your Love : Graham Central Station
