'til I Can Make It On My Own : Tammy Wynette
'til It's Time To Say Goodbye : Jonathan Cain
(Don't Fear) The Reaper : Blue Oyster Cult
(Shake, Shake, Shake) Shake Your Booty : KC And The Sunshine Band
(She's Just A) Fallen Angel : Starz
(The System Of) Doctor Tarr And Professor Fether : The Alan Parsons Project
(one More Year Of) Daddy's Little Girl : Ray Sawyer
50 Ways To Leave Your Lover : Paul Simon
9,999,999 Tears : Dickey Lee
A Dose Of Rock 'N' Roll : Ringo Starr
A Fifth Of Beethoven : Walter Murphy & The Big Apple Band
A Little Bit More : Dr. Hook
Abyssinia Jones : Edwin Starr
Action : Sweet
After The Dance : Marvin Gaye
After The Lovin' : Engelbert Humperdinck
Afternoon Delight : Starland Vocal Band
Ain't Nothing Like The Real Thing : Donny & Marie Osmond
All Roads (Lead Back To You) : Donny Most
Another Rainy Day In New York City : Chicago
Anything You Want : John Valenti
Arms Of Mary : Sutherland Brothers And Quiver
Art For Art's Sake : 10cc
Baby Boy : Mary Kay Place As Loretta Haggers
Baby Face : The Wing And A Prayer Fife & Drum Corps.
Baby, Baby I Love You : Terry Cashman
Baby, I Love Your Way : Peter Frampton
Baby, I'll Give It To You : Seals & Crofts
Baby, We Better Try To Get It Together : Barry White
Back To The Island : Leon Russell
Bad Luck : The Atlanta Disco Band
Banapple Gas : Cat Stevens
Beth/Detroit Rock City : Kiss
Better Place To Be (Parts 1 & 2) : Harry Chapin
Bigfoot : Bro Smith
Blinded By The Light : Manfred Mann's Earth Band
Blt : Lee Oskar
Blue Guitar : Justin Hayward & John Lodge
Brand New Love Affair : Jigsaw
Break Away : Art Garfunkel
Breaker - Breaker : Outlaws
Breakfast For Two : Country Joe McDonald
C'mon Marianne : Donny Osmond
C.b. Savage : Rod Hart
Caledonia : Robin Trower
Can The Can : Suzi Quatro
Can You Do It : Grand Funk Railroad
Can't Change My Heart : Cate Bros.
Can't You See : Waylon Jennings
Car Wash : Rose Royce
Carry On Wayward Son : Kansas
Catfish : Four Tops
Cathedrals : D.C. LaRue
Chain Gang Medley : Jim Croce
Close To You : B.T. Express
Convoy : C.W. McCall
Cotton Candy : The Sylvers
Cupid : Tony Orlando & Dawn
Dancin' Kid : Disco Tex & The Sex-O-Lettes
Daydreamer : C.C. & Company
Dazz : Brick
December, 1963 (Oh, What a Night) : The 4 Seasons
Devil With A Blue Dress : Pratt & McClain
Devil Woman : Cliff Richard
Did You Boogie (With Your Baby) : Flash Cadillac And The Continental Kids
Disco Duck (Part I) : Rick Dees & His Cast Of Idiots
Disco Lady : Johnnie Taylor
Disco Sax/for The Love Of You : Houston Person
Do It To My Mind : Johnny Bristol
Do It With Feeling : Michael Zager's Moon Band/Peabo Bryson
Dog Eat Dog : Ted Nugent
Don't Cry Joni : Conway Twitty with Joni Lee
Don't Go Breaking My Heart : Elton John & Kiki Dee
Don't Leave Me This Way : Thelma Houston
Don't Pull Your Love/then You Can Tell Me Goodbye : Glen Campbell
Don't Stop Believin' : Olivia Newton-John
Don't Touch Me There : The Tubes
Down To Love Town : The Originals
Drivin' Wheel : Foghat
Easy As Pie : Billy Crash Craddock
Eh! Cumpari : Gaylord & Holiday
Enjoy Yourself : The Jacksons
Evergreen (Love Theme From A Star Is Born) : Barbra Streisand
Everyday Without You : Hamilton, Joe Frank & Reynolds
Everything That 'Cha Do (Will Come Back To You) : Wet Willie
Everything's Coming Up Love : David Ruffin
Falling Apart At The Seams : Marmalade
Feelings : Morris Albert
Feelings : Walter Jackson
Fernando : ABBA
Fire : Mother's Finest
Fire On The Mountain : The Marshall Tucker Band
Flight '76 : The Walter Murphy Band
For A Dancer : Prelude
Forever Lovers : Mac Davis
Foxy Lady : Crown Heights Affair
Framed : Cheech & Chong
Free : Deniece Williams
Free Bird : Lynyrd Skynyrd
Free Spirit : Atlanta Rhythm Section
Full Time Thing (Between Dusk And Dawn) : Whirlwind
Get Closer : Seals & Crofts (Featuring Carolyn Willis)
Get Up And Boogie (That's Right) : Silver Convention
Get Up Offa That Thing : James Brown
Getaway : Earth, Wind & Fire
Gimme Your Money Please : Bachman-Turner Overdrive
Give It Up (turn It Loose) : Tyrone Davis
Going Down Slowly : The Pointer Sisters
Golden Years : David Bowie
Good Hearted Woman : Waylon & Willie
Good Vibrations : Todd Rundgren
Got To Get You Into My Life : The Beatles
Gotta Be The One : Maxine Nightingale
Grasshopper : Spin
Growin' Up : Dan Hill
Happy Days : Pratt & McClain with Brother Love
Happy Man (Pt. I) : Impact
Hard Work : John Handy
Harvest For The World : The Isley Brothers
He's A Friend : Eddie Kendricks
Heart On My Sleeve : Bryan Ferry
Heart On My Sleeve : Gallagher And Lyle
Heaven Must Be Missing An Angel (part 1) : Tavares
Hello Old Friend : Eric Clapton
Help Wanted : The Hudson Brothers
Here's Some Love : Tanya Tucker
Here, There And Everywhere : Emmylou Harris
Hey Baby : JJ Cale
Hey Shirley (This Is Squirrely) : Shirley & Squirrely
Hideaway : John Sebastian
Highfly : John Miles
Hit The Road Jack : Stampeders
Hold Back The Night : The Trammps
Hold On : Sons Of Champlin
Hollywood Hot : The Eleventh Hour
Honey Child : Bad Company
Honey I : George McCrae
Hot Stuff/fool To Cry : The Rolling Stones
Howzat : Sherbet
Hurt/for The Heart : Elvis Presley
I Am Somebody : Jimmy James & The Vagabonds
I Believe In Father Christmas : Greg Lake
I Can't Hear You No More/Music Is My Life : Helen Reddy
I Can't Live A Dream : The Osmonds
I Could Have Danced All Night/Jump For Joy : Biddu Orchestra
I Don't Wanna Leave You : Debbie Taylor
I Don't Wanna Lose Your Love : The Emotions
I Heard It Through The Grapevine : Creedence Clearwater Revival Featuring John Fogerty
I Like Dreamin' : Kenny Nolan
I Need To Be In Love : Carpenters
I Never Cry : Alice Cooper
I Only Want To Be With You : Bay City Rollers
I Wish : Stevie Wonder
I'd Really Love To See You Tonight : England Dan & John Ford Coley
I'll Be Good To You : The Brothers Johnson
I'll Get Over You : Crystal Gayle
I'll Play The Fool : Dr. Buzzard's Original Savannah Band
I'm Easy : Keith Carradine
I'm Gonna Let My Heart Do The Walking : The Supremes
I'm So Lonesome I Could Cry : Terry Bradshaw
I've Been Lovin' You : Easy Street
I've Got A Feeling (We'll Be Seeing Each Other Again) : Al Wilson
I.O.U. : Jimmy Dean
If I Only Could : The Rowans
If I Only Knew : Ozark Mountain Daredevils
If Love Must Go : Dobie Gray
If You Know What I Mean : Neil Diamond
If You Only Believe (Jesus For Tonite) : Michel Polnareff
In France They Kiss On Main Street : Joni Mitchell
It Keeps You Runnin' : Carly Simon
It Keeps You Runnin' : The Doobie Brothers
It Should Have Been Me : Yvonne Fair
It's A Long Way There : Little River Band
It's Cool : The Tymes
It's Only Love : ZZ Top
January : Pilot
Jasper : Jim Stafford
Jeans On : David Dundas
Johnny Cool : The Steve Gibbons Band
Junk Food Junkie : Larry Groce
Just To Be Close To You : Commodores
Keep Me Cryin' : Al Green
Kiss And Say Goodbye : The Manhattans
Lady Bump : Penny Mclean
Laid Back Love : Major Harris
Last Child : Aerosmith
Let 'em In : Wings
Let Her In : John Travolta
Let It Shine : Santana
Let Me Down Easy : American Flyer
Let Me In : Derringer
Let Your Love Flow : Bellamy Brothers
Let's Be Young Tonight : Jermaine Jackson
Let's Live Together : The Road Apples
Let's Make A Baby : Billy Paul
Let's Rock : Ellison Chase
Lets Get It Together : El Coco
Light Up The World With Sunshine : Hamilton, Joe Frank & Dennison
Like A Sad Song : John Denver
Listen To The Buddha : Ozo
Livin' Thing : Electric Light Orchestra
Living Next Door To Alice : Smokie
Locomotive Breath : Jethro Tull
Lonely Teardrops : Narvel Felts
Lost Without Your Love : Bread
Love Ballad : L.T.D.
Love Bug : Bumble Bee Unlimited
Love Hangover : Diana Ross
Love Hangover : The 5th Dimension
Love Hurts : Nazareth
Love Is Alive : Gary Wright
Love Is The Drug : Roxy Music
Love Lifted Me : Kenny Rogers
Love Machine (Part 1) : The Miracles
Love Me : Yvonne Elliman
Love Me Tonight : Head East
Love Of My Life : Gino Vannelli
Love Really Hurts Without You : Billy Ocean
Lowdown : Boz Scaggs
Mademoiselle : Styx
Magic Man : Heart
Make Love To Your Mind : Bill Withers
Make Me Smile (Come Up And See Me) : Steve Harley And Cockney Rebel
Makes You Blind : The Glitter Band
Making Our Dreams Come True : Cyndi Grecco
Man Smart, Woman Smarter : Robert Palmer
Mary Hartman, Mary Hartman : The Deadly Nightshade
Message In Our Music : The O'Jays
Mighty High : Mighty Clouds Of Joy
Misty Blue : Dorothy Moore
Moonlight Feels Right : Starbuck
Moonlight Serenade : Bobby Vinton
More Than A Feeling : Boston
More, More, More Pt. 1 : Andrea True Connection
Movin' : Brass Construction
Mozambique : Bob Dylan
My Little Town : Simon & Garfunkel
My Sweet Summer Suite : Love Unlimited Orchestra
Nadia's Theme (The Young And The Restless) : Barry DeVorzon and Perry Botkin, Jr.
Never Gonna Fall In Love Again : Eric Carmen
New Orleans : The Staple Singers
Nice 'N' Naasty : The Salsoul Orchestra
Night Moves : Bob Seger
Norma Jean Wants To Be A Movie Star : Sundown Company
Nursery Rhymes (Part I) : People's Choice
Ode To Billie Joe : Bobbie Gentry
Once A Fool : Kiki Dee
Once You Hit The Road : Dionne Warwick
One Fine Day : Julie
One For The Money (part 1) : The Whispers
One Piece At A Time : Johnny Cash And The Tennessee Three
Only Love Is Real : Carole King
Open : Smokey Robinson
Open Sesame - Part 1 : Kool & The Gang
Ophelia : The Band
Out Of The Darkness : David Crosby/Graham Nash
Paloma Blanca : George Baker Selection
Part Time Love : Gladys Knight And The Pips
Party : Van Mccoy
Peter Gunn : Deodato
Play That Funky Music : Wild Cherry
Popsicle Toes : Michael Franks
Prisoner (Captured By Your Eyes) : L.A. Jets
Queen Of My Soul : Average White Band
Rain, Oh Rain : Fools Gold
Rainbow In Your Eyes : Leon & Mary Russell
Remember Me : Willie Nelson
Renegade : Michael Murphey
Rescue Me : Melissa Manchester
Rock And Roll Music : The Beach Boys
Rock Creek Park : The Blackbyrds
Rocky Mountain Music : Eddie Rabbitt
Roots, Rock, Reggae : Bob Marley And The Wailers
Rose Of Cimarron : Poco
Roxy Roller : Sweeney Todd
Roxy Roller : Sweeney Todd Featuring Bryan Guy Adams
Sara Smile : Daryl Hall John Oates
Save It For A Rainy Day : Stephen Bishop
Save Your Kisses For Me : Brotherhood Of Man
Say You Love Me : D.J. Rogers
Say You Love Me : Fleetwood Mac
School Boy Crush : AWB
Scotch On The Rocks : The Band Of The Black
Shake Your Rump To The Funk : The Bar-Kays
Sherry : The Keane Brothers
Shop Around : Captain & Tennille
Shower The People : James Taylor
Silver Heels : Blaze
Since I Fell For You : Charlie Rich
Sixteen Reasons : Laverne & Shirley
Sixteen Tons : The Don Harrison Band
Slow Dancing : Funky Kings
Solitary Man : T.G. Sheppard
Something He Can Feel : Aretha Franklin
Sophisticated Lady (She's A Different Lady) : Natalie Cole
Sorry Seems To Be The Hardest Word : Elton John
Soul Train 75 : Soul Train Gang
Spend Some Time : Elvin Bishop Featuring Mickey Thomas
Springtime Mama : Henry Gross
Squeeze Box : The Who
Stand Tall : Burton Cummings
Steppin' Out : Neil Sedaka
Still The One : Orleans
Street Singin' : Lady Flash
Street Talk : B.C.G. (B.C. Generation)
Strong Enough To Be Gentle : Black Oak Arkansas
Struttin' My Stuff : Elvin Bishop
Summer : War
Sun...Sun...Sun...Pt. I : Ja-Kki
Superstar : Paul Davis
Sweet Summer Music : Attitudes
Sweet Thing : Rufus Featuring Chaka Khan
Take A Hand : Rick Springfield
Take It To The Limit : Eagles
Take The Money And Run : Steve Miller
Tear The Roof Off The Sucker (Give Up The Funk) : Parliament
Teddy Bear : Red Sovine
Teddy Bear's Last Ride : Diana Williams
Tell It Like It Is : Andy Williams
Ten Percent : Double Exposure
Tenth Avenue Freeze-out : Bruce Springsteen
Texas : The Charlie Daniels Band
That'll Be The Day : Linda Ronstadt
That's Why I Love You : Andrew Gold
The Best Disco In Town : The Ritchie Family
The Blind Man In The Bleachers : Kenny Starr
The Boys Are Back In Town : Thin Lizzy
The Call : Anne Murray
The End Is Not In Sight (the Cowboy Tune) : Amazing Rhythm Aces
The Fez : Steely Dan
The Fonz Song : The Heyettes
The Game Is Over (What's The Matter With You) : Brown Sugar
The Homecoming : Hagood Hardy
The Hungry Years : Wayne Newton
The Jam : Graham Central Station
The Last Game Of The Season (A Blind Man In The Bleachers) : David Geddes
The Little Drummer Boy : Moonlion
The Lonely One : Special Delivery Featuring Terry Huff
The More You Do It (The More I Like It Done To Me) : Ronnie Dyson
The Princess And The Punk : Barry Mann
The White Knight : Cledus Maggard And The Citizen's Band
The Wreck Of The Edmund Fitzgerald : Gordon Lightfoot
The Zip : Mfsb
Theme From S.W.A.T. : Rhythm Heritage
This Is It : Melba Moore
This Masquerade : George Benson
This Old Man : Purple Reign
This One's For You : Barry Manilow
This Song : George Harrison
Times Of Your Life : Paul Anka
Today's The Day : America
Tonight's The Night (Gonna Be Alright) : Rod Stewart
Tonight's The Night : S.S.O.
Torn Between Two Lovers : Mary Macgregor
Touch And Go : Ecstasy, Passion & Pain Featuring Barbara Roy
Train Called Freedom : South Shore Commission
Try Me, I Know We Can Make It : Donna Summer
Tubular Bells : The Champs' Boys Orchestra
Turn The Beat Around : Vicki Sue Robinson
Up The Creek (without A Paddle) : The Temptations
Uptown & Country : Tom Scott
Venus : Frankie Avalon
Volare : Al Martino
Wake Up Everybody (Part 1) : Harold Melvin And The Blue Notes
Wake Up Susan : The Spinners
Wanna Make Love (Come Flick My BIC) : Sun
We Can't Hide It Anymore : Larry Santos
We're All Alone : Frankie Valli
Wham Bam (Shang-A-Lang) : Silver
What's The Name Of This Funk (spider Man) : Ramsey Lewis
When Love Has Gone Away : Richard Cocciante
When Love Is New : Arthur Prysock
Where Did Our Love Go : The J. Geils Band
White Bird : David Laflamme
Who'd She Coo? : Ohio Players
Will You Love Me Tomorrow : Dana Valery
With Your Love : Jefferson Starship
Without Your Love (mr. Jordan) : Charlie Ross
Words (are Impossible) : Donny Gerrard
Wow : The Disco Sound Of Andre Gagnon
Year Of The Cat : Al Stewart
Yes, Yes, Yes : Bill Cosby
Yesterday's Hero : John Paul Young
You Are Beautiful : The Stylistics
You Are My Starship : Norman Connors
You Are The Woman : Firefall
You Don't Have To Be A Star (To Be In My Show) : Marilyn McCoo & Billy Davis, Jr.
You Got The Magic : John Fogerty
You Make Me Feel Like Dancing : Leo Sayer
You Ought To Be Havin' Fun : Tower Of Power
You Sexy Thing : Hot Chocolate
You Should Be Dancing : Bee Gees
You To Me Are Everything : Broadway
You To Me Are Everything : The Real Thing
You To Me Are Everything, Part I : Revelation
You'll Lose A Good Thing : Freddy Fender
You'll Never Find Another Love Like Mine : Lou Rawls
You're Fooling You : The Dramatics
You're My Best Friend : Queen
You're My Everything : Lee Garrett
You've Got Me Runnin' : Gene Cotton
Young Hearts Run Free : Candi Staton
Young Love : Ray Stevens
