(Every Time I Turn Around) Back In Love Again : LTD
(Remember The Days Of The) Old Schoolyard : Cat Stevens
(Theme from) Charlie's Angels : Henry Mancini And His Orchestra
(your Love Has Lifted Me) Higher And Higher : Rita Coolidge
9,999,999 Tears : Dickey Lee
A Real Mother For Ya : Johnny Guitar Watson
After The Lovin' : Engelbert Humperdinck
Ain't Gonna Bump No More (with No Big Fat Woman) : Joe Tex
Ain't Nothing Like The Real Thing : Donny & Marie Osmond
All Strung Out On You : John Travolta
All The Kids On The Street : The Hollywood Stars
All You Get From Love Is A Love Song : Carpenters
Amarillo : Neil Sedaka
Angel In Your Arms : Hot
Ariel : Dean Friedman
Arrested For Driving While Blind : ZZ Top
Avenging Annie : Roger Daltrey
Baby Boy : Mary Kay Place As Loretta Haggers
Baby Come Back : Player
Baby Don't Change Your Mind : Gladys Knight And The Pips
Baby Don't You Know : Wild Cherry
Baby Love : Mother's Finest
Baby, You Look Good To Me Tonight : John Denver
Back Together Again : Daryl Hall John Oates
Barracuda : Heart
Be My Girl : The Dramatics
Be My Lady : The Meters
Best Of My Love : The Emotions
Bite Your Lip (Get up and dance!) : Elton John
Black Betty : Ram Jam
Bless The Beasts And Children : Barry DeVorzon and Perry Botkin, Jr.
Bloat On Featuring the Bloaters : Cheech & Chong
Bodyheat (Part 1) : James Brown
Boogie Child : Bee Gees
Boogie Nights : Heatwave
Breakdown : Tom Petty And The Heartbreakers
Brooklyn : Cody Jameson
Burnin' Sky : Bad Company
C'est La Vie : Greg Lake
C.b. Savage : Rod Hart
Caledonia : Robin Trower
Calling Dr. Love : Kiss
Capture Your Heart : Blue
Carry On Wayward Son : Kansas
Cat Scratch Fever : Ted Nugent
Cinderella : Firefall
Cocomotion : El Coco
Come In From The Rain : Captain & Tennille
Could Heaven Ever Be Like This (Part 1) : Idris Muhammad
Couldn't Get It Right : Climax Blues Band
Crackerbox Palace : George Harrison
Da Doo Ron Ron : Shaun Cassidy
Daddy Cool : Boney M
Dance And Shake Your Tambourine : Universal Robot Band
Dance Little Lady Dance : Danny White
Dance, Dance, Dance (Yowsah, Yowsah, Yowsah) : Chic
Dancin' : Crown Heights Affair
Dancin' Man : Q
Darlin' Darlin' Baby (Sweet, Tender, Love) : The O'Jays
Dazz : Brick
Deeply : Anson Williams
DesirÃ©e : Neil Diamond
Devil's Gun : C.J. & Co.
Dis-Gorilla (Part 1) : Rick Dees & His Cast Of Idiots
Disco Inferno : The Trammps
Disco Lucy (i Love Lucy Theme) : Wilton Place Street Band
Discomania : The Lovers
Do It To My Mind : Johnny Bristol
Do What You Wanna Do : T-Connection
Do Ya Wanna Get Funky With Me : Peter Brown
Do You Wanna Make Love : Peter Mccann
Doctor Love : First Choice
Don't It Make My Brown Eyes Blue : Crystal Gayle
Don't Let It Show : The Alan Parsons Project
Don't Let Me Be Misunderstood : Santa Esmeralda Starring Leroy Gomez
Don't Let The Flame Burn Out : Jackie DeShannon
Don't Turn The Light Out : Cliff Richard
Don't Worry Baby : B.J. Thomas
Down The Hall : The 4 Seasons
Down To The Station : B.W. Stevenson
Dreamin : Loleatta Holloway
Dreams : Fleetwood Mac
Drivin' Wheel : Foghat
Easy : Commodores
Emotion : Samantha Sang
Everybody Be Dancin' : Starbuck
Feel The Beat (Everybody Disco) : Ohio Players
Feel The Need : Detroit Emeralds
Feelings : Walter Jackson
Feels Like The First Time : Foreigner
Ffun : Con Funk Shun
Fire Sign : Cory
Flame : Steve Sperry
Flight '76 : The Walter Murphy Band
Float On : The Floaters
Fly At Night : Chilliwack
Fly By Night/In The Mood : Rush
Fly Like An Eagle : Steve Miller
For Elise : The Philarmonics
Freddie : Charlene
Free : Deniece Williams
Free Bird : Lynyrd Skynyrd
From Graceland To The Promised Land : Merle Haggard
Funk It Up (David's Song) : Sweet
Gettin' Ready For Love : Diana Ross
Give A Little Bit : Supertramp
Gloria : Enchantment
God Only Knows : Marilyn Scott
Going In With My Eyes Open : David Soul
Gonna Fly Now (Theme From Rocky) : Maynard Ferguson
Gonna Fly Now : Bill Conti
Gonna Love You More : George Benson
Good Thing Man : Frank Lucas
Goodbye Girl : David Gates
Got To Give It Up (Pt. I) : Marvin Gaye
Grandmother's Song : Steve Martin
Ha Cha Cha (funktion) : Brass Construction
Hail! Hail! Rock And Roll! : Starland Vocal Band
Handy Man : James Taylor
Happier : Paul Anka
Hard Rock Cafe : Carole King
Heard It In A Love Song : The Marshall Tucker Band
Heart On My Sleeve : Bryan Ferry
Heaven On The 7th Floor : Paul Nicholas
Heaven's Just A Sin Away : The Kendalls
Hello Old Friend : Eric Clapton
Hello Stranger : Yvonne Elliman
Here Comes Summer : Wildfire
Here Is Where Your Love Belongs : The Sons Of Champlin
Hey Baby : JJ Cale
Hey Baby : Ringo Starr
High School Dance : The Sylvers
Hold Back The Night : Graham Parker And The Rumour
Hold Tight : Vicki Sue Robinson
Hollywood : Rufus Featuring Chaka Khan
Hound Dog Man (Play It Again) : Lenny LeBlanc
Hurry Sundown : Outlaws
I Believe In Love : Kenny Loggins
I Believe You : Dorothy Moore
I Can't Help Myself : Eddie Rabbitt
I Caught Your Act : The Hues Corporation
I Don't Love You Anymore : Teddy Pendergrass
I Go Crazy : Paul Davis
I Gotta Keep Dancin' : Carrie
I Just Can't Say No To You : Parker McGee
I Just Want To Be Your Everything : Andy Gibb
I Need A Man : Grace Jones
I Think We're Alone Now : The Rubinoos
I Wanna Do It To You : Jerry Butler
I Wouldn't Want To Be Like You : Alan Parsons
I'll Always Call Your Name : Little River Band
I'm Going Down : Rose Royce
I'm In You : Peter Frampton
I'm Your Boogie Man : KC And The Sunshine Band
I've Got Love On My Mind : Natalie Cole
If I Have To Go Away : Jigsaw
If It Don't Fit, Don't Force It : Kellee Patterson
If It's The Last Thing I Do : Thelma Houston
If You're Not Back In Love By Monday : Millie Jackson
If You've Got The Time : The Babys
In The Middle : Tim Moore
In The Mood : Henhouse Five Plus Too
Indian Summer : Poco
It Ain't Love : Tom Powers
It Feels So Good To Be Loved So Bad : The Manhattans
It Keeps You Runnin' : The Doobie Brothers
It Was Almost Like A Song : Ronnie Milsap
It's A Crazy World : Mac McAnally
It's Ecstasy When You Lay Down Next To Me : Barry White
It's In His Kiss (The Shoop Shoop Song) : Kate Taylor
It's Sad To Belong : England Dan & John Ford Coley
Jeans On : David Dundas
Jet Airliner : The Steve Miller Band
Just A Song Before I Go : Crosby, Stills & Nash
Just The Way You Are : Billy Joel
Keep Me Cryin' : Al Green
Knowing Me, Knowing You : ABBA
Kong : Dickie Goodman
L.a. Sunshine : War
Lady (put The Light On Me) : Brownsville Station
Land Of Make Believe : Chuck Mangione With The Hamilton Philharmonic Orchestra
Le Spank : Le Pamplemousse
Let's Clean Up The Ghetto : Philadelphia International All Stars
Lido Shuffle : Boz Scaggs
Life In The Fast Lane : Eagles
Light Of A Clear Blue Morning : Dolly Parton
Livin' In The Life : The Isley Brothers
Living Next Door To Alice : Smokie
Lonely Boy : Andrew Gold
Look Into Your Heart : Aretha Franklin
Looks Like We Made It : Barry Manilow
Lose Again : Linda Ronstadt
Lost Without Your Love : Bread
Love Bug : Bumble Bee Unlimited
Love In 'C' Minor - Pt. I : Cerrone
Love In 'C' Minor : The Heart And Soul Orchestra
Love Is Better In The A.M. (Part 1) : Johnnie Taylor
Love Me One More Time (Just For Old Times Sake) : Karen Nelson And Billy T
Love To The World : L.T.D.
Love's Grown Deep : Kenny Nolan
Lovely Day : Bill Withers
Lucille : Kenny Rogers
Luckenbach, Texas (back To The Basics Of Love) : Waylon Jennings
Mademoiselle : Styx
Magical Mystery Tour : Ambrosia
Mainstreet : Bob Seger
Make It With You : The Whispers
Making A Good Thing Better : Olivia Newton-John
Man Smart, Woman Smarter : Robert Palmer
Margaritaville : Jimmy Buffett
Maybe I'm Amazed : Wings
Mind Bender : Stillwater
Moondance : Van Morrison
My Cherie Amour : Soul Train Gang
My Fair Share : Seals & Crofts
My Heart Belongs To Me : Barbra Streisand
My Pearl : Automatic Man
N.y., You Got Me Dancing : Andrea True Connection
Native New Yorker : Odyssey
Neon Nites : Atlanta Rhythm Section
Nobody Does It Better : Carly Simon
Nothing But A Breeze : Jesse Winchester
Ob-la-di, Ob-la-da : The Beatles
Old Fashioned Boy (You're The One) : Stallion
On And On : Stephen Bishop
On The Border : Al Stewart
Only Love Can Break A Heart : Bobby Vinton
Only The Lucky : Walter Egan
Open Sesame - Part 1 : Kool & The Gang
Part Time Love : Kerry Chater
Peace Of Mind : Boston
Peg : Steely Dan
People In Love : 10cc
Phantom Writer : Gary Wright
Pirate : Cher
Platinum Heroes : Bruce Foster
Prisoner (Captured By Your Eyes) : L.A. Jets
Race Among The Ruins : Gordon Lightfoot
Reach : Orleans
Reaching For The World : Harold Melvin And The Blue Notes
Red Hot : Robert Gordon With Link Wray
Ridin' The Storm Out : REO Speedwagon
Right Time Of The Night : Jennifer Warnes
Ritzy Mambo : The Salsoul Orchestra
Rock And Roll Star : Champagne
Rockaway Beach : Ramones
Romeo : Mr. Big
Roots Medley : Quincy Jones
Runaway : Bonnie Raitt
Sad Eyes : Brooklyn Dreams
Sad Girl : Carl Graves
Sail Away : Sam Neely
Sailing Ships : Mesa
Saturday Nite : Earth, Wind & Fire
Save Me : Donna McDaniel
Save Me : Merrilee Rush
Say You'll Stay Until Tomorrow : Tom Jones
Seaside Woman : Suzy And The Red Stripes
See You When I Git There : Lou Rawls
Send In The Clowns : Judy Collins
Sentimental Lady : Bob Welch
Shakey Ground : Phoebe Snow
She Did It : Eric Carmen
She's Not There : Santana
Sheena Is A Punk Rocker : The Ramones
Short People : Randy Newman
Show You The Way To Go : The Jacksons
Since I Fell For You/I'm Falling In Love : Hodges, James & Smith
Sing : Tony Orlando & Dawn
Sing It, Shout It : Starz
Sir Duke : Stevie Wonder
Six Packs A Day : Billy Lemmons
Sleepwalker : The Kinks
Slide : Slave
Slip Slidin' Away : Paul Simon
Slow Dancin' Don't Turn Me On : Addrisi Brothers
Slow Dancing : Funky Kings
Slowdown : John Miles
Smoke From A Distant Fire : The Sanford/Townsend Band
So High (rock Me Baby And Roll Me Away) : Dave Mason
So You Win Again : Hot Chocolate
Solsbury Hill : Peter Gabriel
Some Enchanted Evening : Jane Olivor
Somebody To Love : Queen
Somethin' 'bout 'cha : Latimore
Something About You : LeBlanc & Carr
Sometimes : Facts Of Life
Sometimes When We Touch : Dan Hill
Sound And Vision : David Bowie
Southern Nights : Glen Campbell
Spaceship Superstar : Prism
Spend Some Time : Elvin Bishop Featuring Mickey Thomas
Spirit In The Night : Manfred Mann's Earth Band
Spring Affair/Winter Melody : Donna Summer
Spring Rain : Silvetti
St. Charles : Jefferson Starship
Stand Tall : Burton Cummings
Star Wars (Main Title) : London Symphony Orchestra
Star Wars Theme/Cantina Band : Meco
Stone Cold Sober : Crawler
Strawberry Letter 23 : The Brothers Johnson
Street Corner Serenade : Wet Willie
Sub-rosa Subway/calling Occupants : Klaatu
Superman : Celi Bee & The Buzzy Bunch
Surfin' USA : Leif Garrett
Swayin' To The Music (slow Dancin') : Johnny Rivers
Telephone Line : Electric Light Orchestra
Telephone Man : Meri Wilson
Ten To Eight : David Castle
That Magic Touch : Angel
The Best Disco In Town : The Ritchie Family
The Doodle Song : Frankie Miller
The Killing Of Georgie (Part I And II) : Rod Stewart
The King Is Gone : Ronnie McDowell
The Next Hundred Years : Al Martino
The Pretender : Jackson Browne
The Rubberband Man : The Spinners
The Whistler : Jethro Tull
Theme From Close Encounters Of The Third Kind : John Williams
Theme From King Kong (Pt. I) : Love Unlimited Orchestra
Theme From Rocky (Gonna Fly Now) : Current
Theme From Rocky (gonna Fly Now) : Rhythm Heritage
There Will Come A Day (I'm Gonna Happen To You) : Smokey Robinson
This Girl (Has Turned Into A Woman) : Mary Macgregor
This Is The Way That I Feel : Marie Osmond
This Will Be A Night To Remember : Eddie Holman
Thunder Island : Jay Ferguson
Time Bomb : Lake
Time Is Movin' : The Blackbyrds
Too Hot To Stop (Pt. 1) : The Bar-Kays
Try It On : Exile
Tryin' To Love Two : William Bell
Turn Loose Of My Leg : Jim Stafford
Turning To You : Charlie
Undercover Angel : Alan O'Day
Until Now : Bobby Arvon
Up Your Nose : Gabriel Kaplan
Uptown Festival (Part 1) : Shalamar
Wake Up And Be Somebody : Brainstorm
Walk Right In : Dr. Hook
Walk This Way : Aerosmith
Watch Closely Now : Kris Kristofferson
Way Down : Elvis Presley
Welcome To Our World (Of Merry Music) : Mass Production
Whatcha Gonna Do? : Pablo Cruise
When I Need You : Leo Sayer
When Love Is New : Arthur Prysock
While I'm Alone : Maze Featuring Frankie Beverly
Whispering/Cherchez La Femme/Se Si Bon : Dr. Buzzard's Original Savannah Band
White Bird : David Laflamme
Whodunit : Tavares
You + Me = Love/Let's Go Down To The Disco : Undisputed Truth
You And Me : Alice Cooper
You Are On My Mind : Chicago
You Can't Turn Me Off (In The Middle Of Turning Me On) : High Inergy
You Don't Have To Be A Star (To Be In My Show) : Marilyn McCoo & Billy Davis, Jr.
You Know Like I Know : Ozark Mountain Daredevils
You Light Up My Life : Debby Boone
You Light Up My Life : Kacey Cisyk/Original Cast
You Made Me Believe In Magic : Bay City Rollers
You Make Me Crazy : Sammy Hagar
You Take My Heart Away : James Darren
You're Movin' Out Today : Bette Midler
You're Moving Out Today : Carole Bayer Sager
You're My Driving Wheel : The Supremes
You're My World : Helen Reddy
You're The Only One : Geils
You've Got Me Runnin' : Gene Cotton
Your Own Special Way : Genesis
