#1 Dee Jay : Goody Goody
(Every Time I Turn Around) Back In Love Again : LTD
(I Will Be Your) Shadow In The Street : Allan Clarke
(Our Love) Don't Throw It All Away : Andy Gibb
(What A) Wonderful World : Art Garfunkel With James Taylor & Paul Simon
(You Got To Walk And) Don't Look Back : Peter Tosh with Mick Jagger
1,000 Laughs : Eloise Laws
5.7.0.5. : City Boy
A Little Lovin' (Keeps The Doctor Away) : The Raes
A Little More Love : Olivia Newton-John
A Man I'll Never Be : Boston
A Rock 'N' Roll Fantasy : The Kinks
Africanism/Gimme Some Lovin' : Kongas
Ain't Gonna Eat Out My Heart Anymore : Angel
Ain't Gonna' Hurt Nobody : Brick
Ain't Nothing Gonna Keep Me From You : Teri DeSario
Ain't That Enough For You : John Davis And The Monster Orchestra
Alive Again : Chicago
Almost Summer : Celebration featuring Mike Love
Always And Forever : Heatwave
Any Way You Want Me : The Sylvers
Arms Of Mary : Chilliwack
As : Stevie Wonder
Back In My Arms Again : Genya Ravan
Badlands : Bruce Springsteen
Beast Of Burden : The Rolling Stones
Because The Night : Patti Smith Group
Belle : Al Green
Bicycle Race/Fat Bottomed Girls : Queen
Blame It On The Boogie : Mick Jackson
Blame It On The Boogie : The Jacksons
Bloat On Featuring the Bloaters : Cheech & Chong
Blue Collar Man (Long Nights) : Styx
Bluer Than Blue : Michael Johnson
Bombs Away : Bob Weir
Boogie Oogie Oogie : A Taste Of Honey
Break It To Them Gently : Burton Cummings
Ca Plane Pour Moi : Plastic Bertrand
Can We Still Be Friends : Todd Rundgren
Can You Fool : Glen Campbell
Change Of Heart : Eric Carmen
Chattanooga Choo Choo : Tuxedo Junction
Close The Door : Teddy Pendergrass
Come Go With Me : Pockets
Come Together : Aerosmith
Curious Mind (Um, Um, Um, Um, Um, Um) : Johnny Rivers
Cuz It's You, Girl : James Walsh Gypsy Band
Dance (Disco Heat) : Sylvester
Dance Across The Floor : Jimmy Bo Horne
Dance With Me : Peter Brown with Betty Wright
Dancin' Fever : Claudja Barry
Dancin' Shoes : Faith Band
Dancin' Shoes : Nigel Olsson
Dancing In Paradise : El Coco
Dancing In The City : Marshall Hain
Darlin' : Paul Davis Feat. Susan Collins
Daylight And Darkness : Smokey Robinson
Deacon Blues : Steely Dan
DesirÃ©e : Neil Diamond
Devoted To You : Carly Simon & James Taylor
Disco Inferno : The Trammps
Do You Believe In Magic : Shaun Cassidy
Do You Feel All Right : KC And The Sunshine Band
Do You Wanna Dance : Ramones
Don't Ask My Neighbors : The Emotions
Don't Cost You Nothing : Ashford & Simpson
Don't Cry Out Loud : Melissa Manchester
Don't Hold Back : Chanson
Don't Let Me Be Misunderstood : Santa Esmeralda Starring Leroy Gomez
Don't Want To Live Without It : Pablo Cruise
Double Vision : Foreigner
Dreadlock Holiday : 10cc
Dream Lover : The Marshall Tucker Band
Driftwood : The Moody Blues
Dust In The Wind : Kansas
Ease On Down The Road : Diana Ross Michael Jackson
Easy To Love : Leo Sayer
Ebony Eyes : Bob Welch
Emotion : Samantha Sang
Every 1's A Winner : Hot Chocolate
Every Kinda People : Robert Palmer
Everybody Loves A Rain Song : B.J. Thomas
Everybody Needs Love : Stephen Bishop
Falling : LeBlanc & Carr
Feels So Good : Chuck Mangione
Fire : The Pointer Sisters
Flash Light : Parliament
Flyin' : Prism
Follow You Follow Me : Genesis
Forever Autumn : Justin Hayward
Free Me From My Freedom/Tie Me To A Tree (Handcuff Me) : Bonnie Pointer
Fun Time : Joe Cocker
Galaxy : War
Georgia On My Mind : Willie Nelson
Get Back : Billy Preston
Get Off : Foxy
Gettin' Ready For Love : Diana Ross
God Only Knows : Marilyn Scott
Goodbye Girl : David Gates
Got To Be Real : Cheryl Lynn
Got To Have Loving : Don Ray
Grease : Frankie Valli
Greased Lightnin' : John Travolta
He's So Fine : Jane Olivor
He's So Fine : Kristy And Jimmy McNichol
Hold Me, Touch Me : Paul Stanley
Hold The Line : Toto
Hollywood : Boz Scaggs
Home And Dry : Gerry Rafferty
Honey Don't Leave L.a. : James Taylor
Hot Child In The City : Nick Gilder
Hot Legs : Rod Stewart
Hot Shot : Karen Young
House Of The Rising Sun : Santa Esmeralda
How Can I Leave You Again : John Denver
How Much I Feel : Ambrosia
How You Gonna See Me Now : Alice Cooper
I Can't Hold On : Karla Bonoff
I Can't Stand The Rain : Eruption
I Can't Wait Any Longer : Bill Anderson
I Don't Wanna Go : Joey Travolta
I Just Wanna Stop : Gino Vannelli
I Love My Music : Wild Cherry
I Love The Nightlife (Disco 'Round) : Alicia Bridges
I Love You, I Love You, I Love You : Ronnie McDowell
I Need To Know : Tom Petty And The Heartbreakers
I Want You To Be Mine : Kayak
I Was Made For Dancin' : Leif Garrett
I Will Be In Love With You : Livingston Taylor
I Will Still Love You : Stonebolt
I Will Survive : Gloria Gaynor
I'm Every Woman : Chaka Khan
I'm Gonna Make You Love Me : The Blend
I'm Gonna Take Care Of Everything : Rubicon
If Ever I See You Again : Roberta Flack
If I Can't Have You : Yvonne Elliman
If It Don't Fit, Don't Force It : Kellee Patterson
If My Friends Could See Me Now : Linda Clifford
If You Wanna Do A Dance : The Spinners
If You're Not Back In Love By Monday : Millie Jackson
Imaginary Lover : Atlanta Rhythm Section
In For The Night : The Dirt Band
In The Bush : Musique
Instant Replay : Dan Hartman
It's A Heartache : Bonnie Tyler
It's A Heartache : Juice Newton
It's A Laugh : Daryl Hall John Oates
It's Really You : The Tarney/Spencer Band
It's You That I Need : Enchantment
Jack And Jill : Raydio
King Tut : Steve Martin and the Toot Uncommons
Kiss You All Over : Exile
Lady Love : Lou Rawls
Lay Down Sally : Eric Clapton
Le Freak : Chic
Le Spank : Le Pamplemousse
Let Me Party With You (Part 1) (Party, Party, Party) : Bunny Sigler
Let The Song Last Forever : Dan Hill
Let's All Chant : The Michael Zager Band
Let's Get Crazy Tonight : Rupert Holmes
Let's Live Together : Cazz
Life's Been Good : Joe Walsh
Light The Sky On Fire : Jefferson Starship
Like A Sunday In Salem (The Amos & Andy Song) : Gene Cotton
Listen To Her Heart : Tom Petty
Long Hot Summer Nights : Wendy Waldman
Lotta Love : Nicolette Larson
Louie, Louie : John Belushi
Love Is In The Air : John Paul Young
Love Is Like Oxygen : Sweet
Love Me Again : Rita Coolidge
Love Me Right : Denise LaSalle
Love Theme From Eyes Of Laura Mars (Prisoner) : Barbra Streisand
Lovely Day : Bill Withers
MacArthur Park : Donna Summer
Magnet And Steel : Walter Egan
Make You Feel Love Again : Wet Willie
Makin' Love : Climax Blues Band
Mama Let Him Play : Doucette
Mammas Don't Let Your Babies Grow Up To Be Cowboys : Waylon & Willie
Martha (Your Lovers Come And Go) : Gabriel
Mary Jane : Rick James
MaÃ±ana : Jimmy Buffett
Mellow Lovin' : Judy Cheeks
Miles Away : Fotomaker
Mind Bender : Stillwater
Miss Broadway : Belle Epoque
More Than A Woman : Tavares
Music, Harmony And Rhythm : Brooklyn Dreams
My Angel Baby : Toby Beau
My Best Friend's Girl : The Cars
My Life : Billy Joel
My Way : Elvis Presley
Native New Yorker : Odyssey
Never Get Enough Of Your Love : L.T.D.
New Orleans Ladies : Louisiana's Le Roux
New York City : Zwol
New York Groove : Ace Frehley
Oh! Darling : Robin Gibb
On Broadway : George Benson
On The Shelf : Donny & Marie Osmond
On The Strip : Paul Nicholas
On The Wrong Track : Kevin Lamb
One Last Kiss : The J. Geils Band
One Nation Under A Groove - Part I : Funkadelic
Only One Love In My Life : Ronnie Milsap
Only You : Loleatta Holloway And Bunny Sigler
Ooh Baby Baby : Linda Ronstadt
Ooh Boy : Rose Royce
Our Love : Natalie Cole
Over The Rainbow : Gary Tanner
Part-Time Love : Elton John
Peggy Sue : The Beach Boys
Please Come Home For Christmas : Eagles
Promises : Eric Clapton And His Band
Radioactive : Gene Simmons
Raise A Little Hell : Trooper
Reach For It : George Duke
Ready For The Times To Get Better : Crystal Gayle
Ready Or Not : Helen Reddy
Ready To Take A Chance Again : Barry Manilow
Reminiscing : Little River Band
Rivers Of Babylon : Boney M
Rocket Ride : Kiss
Rumor At The Honky Tonk : Spellbound
Run For Home : Lindisfarne
Running On Empty : Jackson Browne
Searching For A Thrill : Starbuck
Send In The Clowns : Judy Collins
September : Earth, Wind & Fire
Sgt. Pepper's Lonely Hearts Club Band/With A Little Help From My Friends : The Beatles
Shake And Dance With Me : Con Funk Shun
Shake It : Ian Matthews
Shake Your Groove Thing : Peaches & Herb
Shaker Song : Spyro Gyra
Shame : Evelyn Champagne King
Sharing The Night Together : Dr. Hook
She Loves To Be In Love : Charlie
Short People : Randy Newman
Silver Dreams : The Babys
Since You Been Gone : Head East
Sitting In Limbo : Don Brown
Slip Slidin' Away : Paul Simon
So Hard Livin' Without You : Airwaves
So Young, So Bad : Starz
Soft And Wet : Prince
Soul Man : Blues Brothers
Stay : Rufus/Chaka Khan
Stay Awhile : Continental Miniatures
Stone Blue : Foghat
Storybook Children (Daybreak) : Bette Midler
Straight On : Heart
Strange Way : Firefall
Stuff Like That : Quincy Jones
Substitute : Clout
Summer Nights : John Travolta & Olivia Newton-John & Cast
Supernature : Cerrone
Surrender : Cheap Trick
Sweet Life : Paul Davis
Sweet Talkin' Woman : Electric Light Orchestra
Sweet, Sweet Smile : Carpenters
Swingtown : The Steve Miller Band
Take A Chance On Me : ABBA
Take Me I'm Yours : Michael Henderson
Take Me To The River : Talking Heads
Thank God It's Friday : Love And Kisses
Thank You For Being A Friend : Andrew Gold
That Once In A Lifetime : Demis Roussos
That's Your Secret : Sea Level
The Circle Is Small (I Can See It In Your Eyes) : Gordon Lightfoot
The Closer I Get To You : Roberta Flack with Donny Hathaway
The Dream Never Dies : Cooper Brothers
The Gambler : Kenny Rogers
The Joker : Snail
The Loneliest Man On The Moon : David Castle
The Next Hundred Years : Al Martino
The Power Of Gold : Dan Fogelberg/Tim Weisberg
The Way I Feel Tonight : Bay City Rollers
The Wedding Song (There Is Love) : Mary Macgregor
Theme From Close Encounters Of The Third Kind : John Williams
Theme Song From Which Way Is Up : Stargard
Themes From The Wizard Of Oz : Meco
There'll Never Be : Switch
Think It Over : Cheryl Ladd
This Is Love : Paul Anka
This Moment In Time : Engelbert Humperdinck
This Night Won't Last Forever : Bill LaBounty
This Time I'm In It For Love : Player
Three Times A Lady : Commodores
Thunder Island : Jay Ferguson
Time For Me To Fly : REO Speedwagon
Time Passages : Al Stewart
Too Much Heaven : Bee Gees
Too Much, Too Little, Too Late : Johnny Mathis/Deniece Williams
Touch And Gone : Gary Wright
Trans-europe Express : Kraftwerk
Tried To Love : Peter Frampton
Two Doors Down : Dolly Parton
Under The Boardwalk : Billy Joe Royal
Until Now : Bobby Arvon
Use Ta Be My Girl : The O'Jays
Warm Ride : Rare Earth
Was Dog A Doughnut : Cat Stevens
Wavelength : Van Morrison
We Fell In Love While Dancing : Bill Brandon
We'll Never Have To Say Goodbye Again : England Dan & John Ford Coley
We've Got Tonight : Bob Seger & The Silver Bullet Band
Well All Right : Santana
Werewolves Of London : Warren Zevon
What Goes Up : The Alan Parsons Project
What You Won't Do For Love : Bobby Caldwell
What's Your Name, What's Your Number : Andrea True Connection
Whatever Happened To Benny Santini? : Chris Rea
Wheel In The Sky : Journey
When You Feel Love : Bob Mcgilpin
Whenever I Call You Friend : Kenny Loggins
Who Are You : The Who
Wild In The Streets : British Lions
Will You Still Love Me Tomorrow : Dave Mason
With A Little Luck : Wings
Woman To Woman : Barbara Mandrell
Y.M.C.A. : Village People
Yank Me, Crank Me : Ted Nugent
You : The McCrarys
You Belong To Me : Carly Simon
You Brought The Woman Out Of Me : Hot
You Can Do It : Dobie Gray
You Can't Turn Me Off (In The Middle Of Turning Me On) : High Inergy
You Don't Bring Me Flowers : Barbra Streisand & Neil Diamond
You Don't Love Me Anymore : Eddie Rabbitt
You Got That Right : Lynyrd Skynyrd
You Light Up My Life : Debby Boone
You Make Loving Fun : Fleetwood Mac
You Make Me Crazy : Sammy Hagar
You Needed Me : Anne Murray
You Never Done It Like That : Captain & Tennille
You Really Got Me : Van Halen
You Took The Words Right Out Of My Mouth : Meat Loaf
You'll Love Again : Hotel
You're A Part Of Me : Gene Cotton With Kim Carnes
You're All I Need To Get By : Johnny Mathis & Deniece Williams
You're The Love : Seals & Crofts
You're The One That I Want : John Travolta & Olivia Newton-John
You've Really Got A Hold On Me : Eddie Money
Your Sweetness Is My Weakness : Barry White
