(Call Me) When The Spirit Moves You : Touch
(Ghost) Riders In The Sky : Outlaws
(Just Like) Starting Over : John Lennon
(Sartorial Eloquence) Don't Ya Wanna Play This Game No More? : Elton John
9 To 5 : Dolly Parton
99 : Toto
A Certain Girl : Warren Zevon
A Lesson In Leavin' : Dottie West
A Lover's Holiday : Change
Ah! Leah! : Donnie Iris
Alabama Getaway : Grateful Dead
All Night Long : Joe Walsh
All Night Thing : Invisible Man's Band
All Out Of Love : Air Supply
An American Dream : The Dirt Band
And The Beat Goes On : The Whispers
And The Cradle Will Rock... : Van Halen
Angel Say No : Tommy Tutone
Angeline : The Allman Brothers Band
Another Brick In The Wall (Part II) : Pink Floyd
Ashes By Now : Rodney Crowell
Autograph : John Denver
Baby Don't Go : Karla Bonoff
Back Of My Hand (I've Got Your Number) : The Jags
Back On My Feet Again : The Babys
Bad Times : Tavares
Better Love Next Time : Dr. Hook
Blues Power : Eric Clapton And His Band
Bounce, Rock, Skate, Roll Pt. 1 : Vaughan Mason And Crew
Brass In Pocket (I'm Special) : Pretenders
Brite Eyes : Robbin Thompson Band
Can We Still Be Friends : Robert Palmer
Can't Put A Price On Love : The Knack
Can't We Try : Teddy Pendergrass
Cars : Gary Numan
Case Of You : Frank Stallone
Catching The Sun : Spyro Gyra
Chiquitita : ABBA
Clones (We're All) : Alice Cooper
Coming Down From Love : Bobby Caldwell
Coming Up (Live At Glasgow) : Paul McCartney & Wings
Computer Game Theme From The Circus : Yellow Magic Orchestra
Cool Change : Little River Band
Coward Of The County : Kenny Rogers
Crazy Little Thing Called Love : Queen
Cruisin' : Smokey Robinson
Cry Like A Baby : Kim Carnes
Dancin' Like Lovers : Mary Macgregor
Darlin' : Yipes!!
Daydream Believer : Anne Murray
De Do Do Do, De Da Da Da : The Police
Deep Inside My Heart : Randy Meisner
Deja Vu : Dionne Warwick
Desire : Andy Gibb
Desire : Rockets
Dig The Gold : Joyce Cobb
Dirty Water : The Inmates
Do Right : Paul Davis
Do That To Me One More Time : Captain & Tennille
Do You Love What You Feel : Rufus & Chaka
Don't Ask Me Why : Billy Joel
Don't Cry For Me Argentina : Festival
Don't Do Me Like That : Tom Petty And The Heartbreakers
Don't Fall In Love With A Dreamer : Kenny Rogers with Kim Carnes
Don't Let Go : Isaac Hayes
Don't Make Me Over : Jennifer Warnes
Don't Misunderstand Me : Rossington Collins Band
Don't Push It Don't Force It : Leon Haywood
Don't Say Goodnight (It's Time For Love) (Parts 1 & 2) : The Isley Brothers
Don't Say No : Billy Burnette
Don't Want No-Body : J.D. Drews
Dreamer : Supertramp
Drivin' My Life Away : Eddie Rabbitt
Emotional Rescue : The Rolling Stones
Empire Strikes Back (Medley) : Meco
Escape (The Pina Colada Song) : Rupert Holmes
Everybody's Got To Learn Sometime : The Korgis
Fame : Irene Cara
Fashion : David Bowie
Fire In The Morning : Melissa Manchester
First Time Love : Livingston Taylor
First...Be A Woman : Lenore O'malley
Flirtin' With Disaster : Molly Hatchet
Fool For A Pretty Face (Hurt By Love) : Humble Pie
Fool For Your Loving : Whitesnake
Fool In The Rain : Led Zeppelin
Forever Mine : The O'Jays
Funkytown : Lipps, Inc.
Games People Play : The Alan Parsons Project
Games Without Frontiers : Peter Gabriel
Gee Whiz : Bernadette Peters
Gimme Some Lovin' : Blues Brothers
Give It All You Got : Chuck Mangione
Give Me The Night : George Benson
Giving It Up For Your Love : Delbert McClinton
Glide : Pleasure
Goin' On : The Beach Boys
Goodnight My Love : Mike Pinera
Got To Love Somebody : Sister Sledge
Gotta Have More Love : Climax Blues Band
Guilty : Barbra Streisand & Barry Gibb
Gypsy Spirit : Pendulum
Half Moon Silver : Hotel
Half The Way : Crystal Gayle
Haven't You Heard : Patrice Rushen
He Can't Love You : Michael Stanley Band
He's So Shy : The Pointer Sisters
Head Games : Foreigner
Headed For A Fall : Firefall
Heartbreaker : Pat Benatar
Help Me! : Marcy Levy & Robin Gibb
Hey Nineteen : Steely Dan
High On Your Love : Debbie Jacobs
Hold On : Kansas
Hold On To My Love : Jimmy Ruffin
Holdin' On For Dear Love : Lobo
Holiday : Nazareth
Honey, Honey : David Hudson
Hot Rod Hearts : Robbie Dupree
How Do I Survive : Amy Holland
Hungry Heart : Bruce Springsteen
Hurt So Bad : Linda Ronstadt
I Believe In You : Don Williams
I Call Your Name : Switch
I Can Survive : Triumph
I Can't Help It : Andy Gibb & Olivia Newton-John
I Can't Help Myself (Sugar Pie, Honey Bunch) : Bonnie Pointer
I Could Be Good For You : 707
I Don't Like Mondays : The Boomtown Rats
I Don't Need You Anymore : Together? (Soundtrack) Featuring Jackie DeShannon
I Don't Want To Be Lonely : Dana Valery
I Don't Want To Talk About It : Rod Stewart
I Get Off On It : Tony Joe White
I Got You : Split Enz
I Hear You Now : Jon & Vangelis
I Like To Rock : April Wine
I Love Women : Jim Hurt
I Need Your Lovin' : Teena Marie
I Only Want To Be With You : The Tourists
I Pledge My Love : Peaches & Herb
I Shoulda Loved Ya : Narada Michael Walden
I Still Have Dreams : Richie Furay
I Thank You : ZZ Top
I Wanna Be Your Lover : Prince
I Want You Tonight : Pablo Cruise
I Wish I Was Eighteen Again : George Burns
I'd Rather Leave While I'm In Love : Rita Coolidge
I'm Alive : Gamma
I'm Almost Ready : Pure Prairie League
I'm Happy That Love Has Found You : Jimmy Hall
I've Just Begun To Love You : Dynasty
If I Were You : Toby Beau
If You Should Sail : Nielsen/Pearson
In It For Love : England Dan & John Ford Coley
Into The Night : Benny Mardones
Is This Love : Pat Travers Band
It Hurts Too Much : Eric Carmen
It Takes Time : The Marshall Tucker Band
It's A Night For Beautiful Girls : The Fools
It's For You : Player
Jane : Jefferson Starship
Jesse : Carly Simon
Just For The Moment : Ray Kennedy
Keep On Loving You : REO Speedwagon
Killin' Time : Fred Knoblock & Susan Anton
King Of The Hill : Rick Pinette & Oak
Kiss Me In The Rain : Barbra Streisand
Ladies Night : Kool & The Gang
Landlord : Gladys Knight And The Pips
Last Train To London : Electric Light Orchestra
Late At Night : England Dan Seals
Late In The Evening : Paul Simon
Leaving L.A. : Deliverance
Let Me Be : Korona
Let Me Be Your Angel : Stacy Lattisaw
Let Me Go, Love : Nicolette Larson & Michael McDonald
Let Me Sleep Alone : Cugini
Let My Love Open The Door : Pete Townshend
Let's Be Lovers Again : Eddie Money (with Valerie Carter)
Let's Do Something Cheap And Superficial : Burt Reynolds
Let's Go 'Round Again : Average White Band
Live Every Minute : Ali Thomson
Lola : The Kinks
Lonely Eyes : Robert John
Longer : Dan Fogelberg
Look What You've Done To Me : Boz Scaggs
Lookin' For Love : Johnny Lee
Looks Like Love Again : Dann Rogers
Lost Her In The Sun : John Stewart
Love And Loneliness : The Motors
Love On The Phone : Suzanne Fellini
Love Pains : Yvonne Elliman
Love Stinks : The J. Geils Band
Love's Only Love : Engelbert
Lovely One : The Jacksons
Loving You With My Eyes : Starland Vocal Band
Magic : Olivia Newton-John
Make Believe It's Your First Time : Bobby Vinton
Memorize Your Number : Leif Garrett
Merry Christmas In The NFL : Willis The Guard & Vigorish
Midnight Rain : Poco
Midnight Rocks : Al Stewart
Mirage : Eric Troyer
Mistrusted Love : Mistress
Money : The Flying Lizards
More Bounce To The Ounce Part I : Zapp
More Than I Can Say : Leo Sayer
Move Your Boogie Body : Bar-Kays
My Guy/My Girl : Amii Stewart & Johnny Bristol
My Mistake : The Kingbees
Never Knew Love Like This Before : Stephanie Mills
New Romance (It's A Mystery) : Spider
No More Tears (Enough Is Enough) : Barbra Streisand/Donna Summer
On The Radio : Donna Summer
On The Rebound : Russ Ballard
On The Road Again : Willie Nelson
Once A Night : Jackie English
One Fine Day : Carole King
One In A Million You : Larry Graham
One Life To Live : Wayne Massey
Only A Lonely Heart Sees : Felix Cavaliere
Only The Lonely (Have A Reason To Be Sad) : La Flavour
Over You : Roxy Music
Peanut Butter : Twennynine Featuring Lenny White
Pilot Of The Airwaves : Charlie Dore
Please Don't Go : KC And The Sunshine Band
Pop Muzik : M
Power : The Temptations
Rainbow Connection : Kermit (Jim Henson)
Rapper's Delight : Sugarhill Gang
Real Love : The Cretones
Real Love : The Doobie Brothers
Rebels Are We : Chic
Red Light : Linda Clifford
Remember (Walking In The Sand) : Aerosmith
Remote Control : The Reddings
Rock Lobster : The B-52s
Rock With You : Michael Jackson
Rockin' Into The Night : 38 Special
Romeo's Tune : Steve Forbert
Rotation : Herb Alpert
Running Back : Eddie Money
Sailing : Christopher Cross
Sara : Fleetwood Mac
Savannah Nights : Tom Johnston
Save Me : Dave Mason
Scandal : RCR
Seasons : Grace Slick
Send One Your Love : Stevie Wonder
September Morn' : Neil Diamond
Sequel : Harry Chapin
Set Me Free : Utopia
Set The Night On Fire : Oak
Shandi : Kiss
She's In Love With You : Suzi Quatro
Shine On : L.T.D.
Shining Star : The Manhattans
Shiver And Shake : The Silencers
Shooting Star : Dollar
Shotgun Rider : Joe Sun
Should've Never Let You Go : Neil Sedaka & Dara Sedaka
Since You Been Gone : Rainbow
Skateaway : Dire Straits
Slipstream : Allan Clarke
Smoky Mountain Rain : Ronnie Milsap
Solitaire : Peter McIan
Someone That I Used To Love : Natalie Cole
Somethin' 'Bout You Baby I Like : Glen Campbell & Rita Coolidge
Somewhere In America : Survivor
Special Lady : Ray, Goodman & Brown
Spend The Night In Love : The 4 Seasons
Stand By Me : Mickey Gilley
Star : Earth, Wind & Fire
Stargazer : Peter Brown
Stay In Time : Off Broadway USA
Stomp! : The Brothers Johnson
Suddenly : Olivia Newton-John & Cliff Richard
Switchin' To Glide/This Beat Goes On : The Kings
Take You Tonight : Ozark Mountain Daredevils
Take Your Time (Do It Right) Part 1 : The S.O.S. Band
Takin' It Back : Breathless
Teacher Teacher : Rockpile
Tell It Like It Is : Heart
Texas In My Rear View Mirror : Mac Davis
That Girl Could Sing : Jackson Browne
That Lovin' You Feelin' Again : Roy Orbison & Emmylou Harris
The Breaks (Part 1) : Kurtis Blow
The Legend Of Wooley Swamp : The Charlie Daniels Band
The Long Run : Eagles
The Part Of Me That Needs You Most : Jay Black
The Royal Mile (Sweet Darlin') : Gerry Rafferty
The Second Time Around : Shalamar
The Seduction (Love Theme) : James Last Band
The Spirit Of Radio : Rush
The Tide Is High : Blondie
Theme From New York, New York : Frank Sinatra
Theme From The Dukes Of Hazzard (Good Ol' Boys) : Waylon
Third Time Lucky (First Time I Was A Fool) : Foghat
This Is It : Kenny Loggins
This Time : John Cougar
Three Times In Love : Tommy James
Thunder And Lightning : Chicago
Tired Of Toein' The Line : Rocky Burnette
Together : Tierra
Too Late : Journey
Touch And Go : The Cars
Train In Vain (Stand By Me) : The Clash
Train, Train : Blackfoot
Trickle Trickle : The Manhattan Transfer
Trust Me : Cindy Bullens
Turn It On Again : Genesis
Turning Japanese : The Vapors
Two Places At The Same Time : Ray Parker Jr. & Raydio
United Together : Aretha Franklin
Upside Down : Diana Ross
Us And Love (We Go Together) : Kenny Nolan
Video Killed The Radio Star : The Buggles
Voice Of Freedom : Jim Kirk And The Tm Singers
Voices : Cheap Trick
Volcano : Jimmy Buffett
Wait For Me : Daryl Hall John Oates
Wango Tango : Ted Nugent
We Don't Talk Anymore : Cliff Richard
We Were Meant To Be Lovers : Photoglo
What Can You Get A Wookiee For Christmas (When He Already Owns A Comb?) : The Star Wars Intergalactic Droid Choir & Chorale
What I Like About You : The Romantics
What's Your Hurry Darlin' : Ironhorse
Whatever You Decide : Randy Vanwarmer
When A Man Loves A Woman : Bette Midler
When I Wanted You : Barry Manilow
When Things Go Wrong : Robin Lane & The Chartbusters
Where Did We Go Wrong : Frankie Valli & Chris Forde
Where Does The Lovin' Go : David Gates
Whip It : Devo
White Hot : Red Rider
Who Shot J.R.? : Gary Burbank with Band McNally
Who Were You Thinkin' Of : The Doolittle Band
Who'll Be The Fool Tonight : Larsen-Feiten Band
Why Me : Styx
Why Not Me : Fred Knoblock
With You I'm Born Again : Billy Preston & Syreeta
Without Your Love : Roger Daltrey
Wondering Where The Lions Are : Bruce Cockburn
Wonderland : Commodores
Working My Way Back To You/Forgive Me, Girl : The Spinners
Xanadu : Olivia Newton-John/Electric Light Orchestra
Years : Wayne Newton
Yes, I'm Ready : Teri DeSario With K.C.
You And Me : Rockie Robbins
You Are My Heaven : Roberta Flack with Donny Hathaway
You Can Call Me Blue : Michael Johnson
You Know That I Love You : Santana
You Might Need Somebody : Turley Richards
You Shook Me All Night Long : AC/DC
You'll Accomp'ny Me : Bob Seger
You're Gonna Get What's Coming : Bonnie Raitt
You're My Blessing : Lou Rawls
You're Only Lonely : J.D.Souther
You're Supposed To Keep Your Love For Me : Jermaine Jackson
You're The Only Woman (You & I) : Ambrosia
You've Got What I Need : Shooting Star
