(Ghost) Riders In The Sky : Outlaws
(There's) No Gettin' Over Me : Ronnie Milsap
8th Wonder : Sugarhill Gang
96 Tears : Garland Jeffreys
A Heart In New York : Art Garfunkel
A Life Of Illusion : Joe Walsh
A Lucky Guy : Rickie Lee Jones
A Woman Needs Love (Just Like You Do) : Ray Parker Jr. & Raydio
A World Without Heroes : Kiss
Ai No Corrida (I-No-Ko-ree-da) : Quincy Jones
Aiming At Your Heart : The Temptations
Ain't Even Done With The Night : John Cougar
Alien : Atlanta Rhythm Section
All I Have To Do Is Dream : Andy Gibb & Victoria Principal
All Our Tomorrows : Eddie Schwartz
All Those Years Ago : George Harrison
Almost Saturday Night : Dave Edmunds
America : Neil Diamond
American Memories : Shamus M'Cool
Another Ticket : Eric Clapton
Arc Of A Diver : Steve Winwood
Arthur's Theme (Best That You Can Do) : Christopher Cross
Back In Black : AC/DC
Back To The 60's : Tight Fit
Being With You : Smokey Robinson
Bet Your Heart On Me : Johnny Lee
Bette Davis Eyes : Kim Carnes
Bon Bon Vie (Gimme The Good Life) : T.S. Monk
Boy From New York City : The Manhattan Transfer
Breakfast In America : Supertramp
Breaking Away : Balance
Brooklyn Girls : Robbie Dupree
Burnin' For You : Blue Oyster Cult
But You Know I Love You : Dolly Parton
Cafe Amore : Spyro Gyra
Can't Hold Back (Your Loving) : Kano
Centerfold : The J. Geils Band
Ch Ch Cherie : The Johnny Average Band Featuring Nikki Wills
Chariots Of Fire - Titles : Vangelis
Come To Me : Aretha Franklin
Controversy : Prince
Cool Love : Pablo Cruise
Cool Night : Paul Davis
Could It Be Love : Jennifer Warnes
Crazy (Keep On Falling) : The John Hall Band
Dedicated To The One I Love : Bernadette Peters
Destroyer : The Kinks
Don't Give It Up : Robbie Patton
Don't Know Much : Bill Medley
Don't Let Go The Coat : The Who
Don't Stop Believin' : Journey
Don't Stop The Music : Yarbrough & Peoples
Don't Want No-Body : J.D. Drews
Don't Want To Wait Anymore : The Tubes
Don't You Know What Love Is : Touch
Double Dutch Bus : Frankie Smith
Dreamer : The Association
Elvira : The Oak Ridge Boys
Endless Love : Diana Ross & Lionel Richie
Everlasting Love : Rex Smith/Rachel Sweet
Every Home Should Have One : Patti Austin
Every Little Thing She Does Is Magic : The Police
Everybody's Got To Learn Sometime : The Korgis
Fade Away : Bruce Springsteen
Falling In Love Again : Michael Stanley Band
Fantastic Voyage : Lakeside
Fantasy Girl : 38 Special
Fashion : David Bowie
Feel Like A Number : Bob Seger & The Silver Bullet Band
Feels So Right : Alabama
Fire In The Sky : The Dirt Band
Fireflies : Fleetwood Mac
Flash's Theme Aka Flash : Queen
Fly Away : Blackfoot
Fly Away : Peter Allen
Fool In Love With You : Jim Photoglo
Fool That I Am : Rita Coolidge
Gemini Dream : The Moody Blues
General Hospi-tale : The Afternoon Delights
Give A Little Bit More : Cliff Richard
Give It To Me Baby : Rick James
Giving It Up For Your Love : Delbert McClinton
Got To Rock On : Kansas
Guitar Man : Elvis Presley
Gypsy Spirit : Pendulum
Hard Times : James Taylor
Hard To Say : Dan Fogelberg
Harden My Heart : Quarterflash
Heart Like A Wheel : The Steve Miller Band
Hearts : Marty Balin
Hearts On Fire : Randy Meisner
Heavy Metal (Takin' A Ride) : Don Felder
Help Me! : Marcy Levy & Robin Gibb
Her Town Too : James Taylor & J.D. Souther
Hold On : Badfinger
Hooked On Classics : Royal Philharmonic Orchestra
How 'bout Us : Champaign
Hurry Up And Wait : The Isley Brothers
I Believe In You : Don Williams
I Can Take Care Of Myself : Billy & The Beaters
I Can't Say Goodbye To You : Helen Reddy
I Can't Stand It : Eric Clapton And His Band
I Could Never Miss You (More Than I Do) : Lulu
I Don't Need You : Kenny Rogers
I Don't Need You : Rupert Holmes
I Don't Want To Know Your Name : Glen Campbell
I Have The Skill : Sherbs
I Heard It Through The Grapevine (Part 1) : Roger
I Love You : Climax Blues Band
I Loved 'em Every One : T.G. Sheppard
I Surrender : Arlan Day
I Want You, I Need You : Chris Christian
I'm Gonna Love Her For Both Of Us : Meat Loaf
I'm Happy That Love Has Found You : Jimmy Hall
I'm In Love : Evelyn King
I'm Just Too Shy : Jermaine Jackson
I'm So Glad I'm Standing Here Today : The Crusaders With Joe Cocker
I'm Your Superman : All Sports Band
I've Been Waiting For You All Of My Life : Paul Anka
In The Air Tonight : Phil Collins
Is It You : Lee Ritenour
It Didn't Take Long : Spider
It Hurts To Be In Love : Dan Hartman
It's A Love Thing : The Whispers
It's All I Can Do : Anne Murray
It's My Job : Jimmy Buffett
It's My Party : Dave Stewart and Barbara Gaskin
It's Now Or Never : John Schneider
Jesse : Carly Simon
Jessie's Girl : Rick Springfield
Jones Vs. Jones : Kool & The Gang
Just Be My Lady : Larry Graham
Just Like Paradise : Larry John McNally
Just Once : Quincy Jones Featuring James Ingram
Just So Lonely : Get Wet
Just The Two Of Us : Grover Washington, Jr. (with Bill Withers)
Keep This Train A-Rollin' : The Doobie Brothers
Keeping Our Love Alive : Henry Paul Band
Key Largo : Bertie Higgins
Killin' Time : Fred Knoblock & Susan Anton
La La Means I Love You : Tierra
La-Di-Da : Sad Cafe
Lady (You Bring Me Up) : Commodores
Lately : Stevie Wonder
Leather And Lace : Stevie Nicks With Don Henley
Leila : ZZ Top
Let Me Go : The Rings
Let Me Love You Once : Greg Lake
Let's Dance (Make Your Body Move) : West Street Mob
Let's Groove : Earth, Wind & Fire
Let's Put The Fun Back In Rock N Roll : Freddy Cannon & The Belmonts
Lipstick : Suzi Quatro
Little Darlin' : Sheila
Living Eyes : Bee Gees
Living In A Fantasy : Leo Sayer
Living Inside Myself : Gino Vannelli
Long Time Lovin' You : McGuffey Lane
Love All The Hurt Away : Aretha Franklin And George Benson
Love Light : Yutaka
Love On A Two Way Street : Stacy Lattisaw
Love On The Airwaves : Night
Love T.K.O. : Teddy Pendergrass
Love You Like I Never Loved Before : John O'Banion
Lovers After All : Melissa Manchester & Peabo Bryson
Lovin' The Night Away : The Dillman Band
Magic Man : Herb Alpert
Magic Power : Triumph
Make That Move : Shalamar
Medley : Stars On 45
Mercy, Mercy, Mercy : Phoebe Snow
Merry Christmas In The NFL : Willis The Guard & Vigorish
Miss Sun : Boz Scaggs
Mister Sandman : Emmylou Harris
Modern Girl : Sheena Easton
More Stars : More Stars On 45
More Than Just The Two Of Us : Sneaker
My Girl (Gone, Gone, Gone) : Chilliwack
My Mother's Eyes : Bette Midler
Never Knew Love Like This Before : Stephanie Mills
Never Too Much : Luther Vandross
Next Time You'll Know : Sister Sledge
Nicole : Point Blank
No Reply At All : Genesis
No Time To Lose : The Tarney/Spencer Band
Nobody Wins : Elton John
Not Fade Away : Eric Hine
On And On And On : ABBA
On The Road Again : Willie Nelson
Once A Night : Jackie English
One Day In Your Life : Michael Jackson
One More Night : Streek
One-Trick Pony : Paul Simon
Our Lips Are Sealed : Go-Go's
Out Here On My Own : Irene Cara
Paradise : Change
Pay The Devil (Ooo, Baby, Ooo) : The Knack
Pay You Back With Interest : Gary O'
Physical : Olivia Newton-John
Playing With Lightning : Shot In The Dark
Poor Man's Son : Survivor
Precious To Me : Phil Seymour
Promises : Barbra Streisand
Promises In The Dark : Pat Benatar
Proud : The Joe Chemay Band
Queen Of Hearts : Juice Newton
Rain In May : Max Werner
Rapture : Blondie
Ready For Love : Silverado
Really Wanna Know You : Gary Wright
Remote Control : The Reddings
Rich Man : Terri Gibbs
Right Away : Hawks
Rock And Roll Dreams Come Through : Jim Steinman
Run To Me : Savoy Brown
Runaway Rita : Leif Garrett
Running Scared : The Fools
Sausalito Summernight : Diesel
Say Goodbye To Hollywood : Billy Joel
Say What : Jesse Winchester
Sea Of Love : Del Shannon
Seasons : Charles Fox
Secrets : Mac Davis
Seduced : Leon Redbone
Sequel : Harry Chapin
Set The Night On Fire : Oak
Seven Bridges Road : Eagles
Seven Year Ache : Rosanne Cash
Shaddap You Face : Joe Dolce
Shake It Up : The Cars
Shake It Up Tonight : Cheryl Lynn
Sharing The Love : Rufus With Chaka Khan
She Did It : Michael Damian
She's A Bad Mama Jama (She's Built, She's Stacked) : Carl Carlton
Shine On : L.T.D.
Sign Of The Gypsy Queen : April Wine
Silly : Deniece Williams
Since I Don't Have You : Don McLean
Skateaway : Dire Straits
Slow Hand : The Pointer Sisters
Snap Shot : Slave
Some Changes Are For Good : Dionne Warwick
Some Days Are Diamonds (Some Days Are Stone) : John Denver
Somebody Send My Baby Home : Lenny LeBlanc
Someday, Someway : Robert Gordon
Southern Pacific : Neil Young/Crazy Horse
Spend The Night In Love : The 4 Seasons
Square Biz : Teena Marie
Start Me Up : The Rolling Stones
Stay Awake : Ronnie Laws
Staying With It : Firefall
Steal The Night : Stevie Woods
Step By Step : Eddie Rabbitt
Still Right Here In My Heart : Pure Prairie League
Stop Draggin' My Heart Around : Stevie Nicks With Tom Petty And The Heartbreakers
Stop This Game : Cheap Trick
Straight From The Heart : The Allman Brothers Band
Stranger : Jefferson Starship
Stronger Than Before : Carole Bayer Sager
Suddenly : Olivia Newton-John & Cliff Richard
Sukiyaki : A Taste Of Honey
Summer '81 medley : The Cantina Band (featuring Lou Christie)
Suzi : Randy Vanwarmer
Sweet Baby : Stanley Clarke/George Duke
Sweet Merilee : Donnie Iris
Sweetheart : Franke & The Knockouts
Switchin' To Glide/This Beat Goes On : The Kings
Take It On The Run : REO Speedwagon
Take Me Now : David Gates
Teacher Teacher : Rockpile
Tell It Like It Is : Heart
Tempted : Squeeze
That Didn't Hurt Too Bad : Dr. Hook
The Beach Boys Medley : The Beach Boys
The Breakup Song (They Don't Write 'Em) : Greg Kihn Band
The Jam Was Moving : Debbie Harry
The Kid Is Hot Tonite : Loverboy
The Night Owls : Little River Band
The Old Songs : Barry Manilow
The One That You Love : Air Supply
The Rambler : Molly Hatchet
The Real Thing : The Brothers Johnson
The Stroke : Billy Squier
The Sun Ain't Gonna Shine Anymore : Nielsen/Pearson
The Theme From Hill Street Blues : Mike Post featuring Larry Carlton
The Waiting : Tom Petty And The Heartbreakers
The Woman In Me : Crystal Gayle
Theme From Greatest American Hero (Believe It or Not) : Joey Scarbury
Theme From Raging Bull (Cavalleria Rusticana) : Joel Diamond
Theme From The Dukes Of Hazzard (Good Ol' Boys) : Waylon
This Little Girl : Gary U.S. Bonds
Time : The Alan Parsons Project
Time Is Time : Andy Gibb
Time Out Of Mind : Steely Dan
Toccata : Sky
Tom Sawyer : Rush
Tonight Tonight : Bill Champlin
Too Much Time On My Hands : Styx
Too Tight : Con Funk Shun
Touch Me When We're Dancing : Carpenters
Trouble : Lindsey Buckingham
Tryin' To Live My Life Without You : Bob Seger
Turn And Walk Away : The Babys
Turn Your Love Around : George Benson
Turning Japanese : The Vapors
Twilight : Electric Light Orchestra
Two Hearts : Stephanie Mills Featuring Teddy Pendergrass
Under Pressure : Queen & David Bowie
Under The Covers : Janis Ian
Urgent : Foreigner
Very Special : Debra Laws
Walk Right Now : The Jacksons
Walking Into Sunshine : Central Line
Walking On Thin Ice : Yoko Ono
Wasn't That A Party : The Rovers
Watching The Wheels : John Lennon
We Can Get Together : Icehouse
We're In This Love Together : Al Jarreau
What Are We Doin' In Love : Dottie West with Kenny Rogers
What Can You Get A Wookiee For Christmas (When He Already Owns A Comb?) : The Star Wars Intergalactic Droid Choir & Chorale
What Cha' Gonna Do For Me : Chaka Khan
What Kind Of Fool : Barbra Streisand & Barry Gibb
What She Does To Me (The Diana Song) : The Producers
When She Was My Girl : Four Tops
Where's Your Angel? : Lani Hall
Who Do You Think You're Foolin' : Donna Summer
Who's Making Love : Blues Brothers
Why Do Fools Fall In Love : Diana Ross
Winning : Santana
Without Your Love : Roger Daltrey
Wkrp In Cincinnati : Steve Carlisle
Working In The Coal Mine : Devo
Wrack My Brain : Ringo Starr
Yearning For Your Love : The Gap Band
Yesterday Once More/Nothing Remains The Same : The Spinners
You Could Take My Heart Away : Silver Condor
You Don't Know Me : Mickey Gilley
You Make My Dreams : Daryl Hall John Oates
You Saved My Soul : Burton Cummings
You're So Easy To Love : Tommy James
You've Got A Good Love Coming : Van Stephenson
Young Turks : Rod Stewart
