"B" Girls : Young And Restless
(Can t Live Without Your) Love And Affection : Nelson
(It s Just) The Way That You Love Me : Paula Abdul
1-2-3 : The Chimes
500 Miles : Hooters
99 Worlds : Peter Wolf
A Face In The Crowd : Tom Petty
A Girl Like You : The Smithereens
A Little Love : Corey Hart
All I Do Is Think Of You : Troop
All I m Missing Is You : Glenn Medeiros Featuring Ray Parker, Jr.
All Lips N Hips : Electric Boys
All My Life : Linda Ronstadt (Featuring Aaron Neville)
All Nite : Entouch Featuring Keith Sweat
All Or Nothing : Milli Vanilli
All That Glitters Isn t Gold : The Cover Girls
Almost Hear You Sigh : The Rolling Stones
Always And Forever : Whistle
And So It Goes : Billy Joel
Anything I Want : Kevin Paige
Anything Is Possible : Debbie Gibson
Anytime : McAuley Schenker Group
B.B.D. (I Thought It Was Me)? : Bell Biv Devoe
Bad Love : Eric Clapton
Bang Bang : Danger Danger
Banned In The U.S.A. : Luke Featuring The 2 Live Crew
Because I Love You (The Postman Song) : Stevie B
Biscuit s In The House : Biscuit
Black Cat : Janet Jackson
Blue Sky Mine : Midnight Oil
Bounce Back : Alisha
Bust A Move : Young MC
Can t Stop : After 7
Candy : Iggy Pop With Kate Pierson
Chain Of Fools : Little Caesar
Cherry Pie : Warrant
Children Of The Night : Richard Marx
Close To You : Maxi Priest
Club At The End Of The Street : Elton John
Counting The Days : Joey Kid
Cradle Of Love (From "Ford Fairlane") : Billy Idol
Crash (Have Some Fun) : TKA Featuring Michelle Visage
Crazy : The Boys
Cruising For Bruising : Basia
Cuts You Up : Peter Murphy
Dare To Fall In Love : Brent Bourgeois
Days Like These : Asia
Deadbeat Club : The B-52 s
Deeper Shade Of Soul : Urban Dance Squad
Dirty Cash (Money Talks) : The Adventures Of Stevie V
Dirty Deeds : Joan Jett
Does She Love That Man? : Breathe Featuring David Glasper
Doin The Do : Betty Boo
Don t Close Your Eyes : Kix
Don t Take It Personal : Jermaine Jackson
Don t Wanna Fall In Love : Jane Child
Don t You Love Me : 49-ers
Don t You Wanna Be Mine : Denise Lopez
Doubleback (From "Back To The Future Part III") : ZZ Top
Downtown Train : Rod Stewart
Drag My Bad Name Down : The 4 Of Us
Dream Boy/Dream Girl : Cynthia
Each And Every Time : Sweet Sensation
Electric Boogie : Marcia Griffiths
Empty Beach : Tricia Leigh Fisher
Epic : Faith No More
Everybody Everybody : Black Box
Everything You Do (You re Sexing Me) : Fiona (Duet With Kip Winger)
Expression : Salt-N-Pepa
Fairweather Friend : Johnny Gill
Feels Good : Tony Toni Tone
Figure Of Eight : Paul McCartney
First True Love : Tiana
Fly High Michelle : Enuff Z Nuff
Fly To the Angels : Slaughter
Foolish Heart : Sharon Bryant
For You : The Outfield
Forever : Kiss
Freedom : George Michael
French Kiss : Lil Louis
From A Distance : Bette Midler
Get A Life : Soul II Soul
Get Here : Oleta Adams
Get Up! (Before The Night Is Over) : Technotronic
Getting Away With It : Electronic
Gimme Your Good Lovin : Diving For Pearls
Girls Nite Out : Tyler Collins
Give It To Me Good : Trixter
Giving You The Benefit : Pebbles
Go For It! (Heart And Fire) : Joey B. Ellis
Going Home : Kenny G
Gonna Make You Sweat : C+C Music Factory
Got To Get : Leila K With Rob N Raz
Got To Have Your Love : Mantronix Featuring Wondress
Got To Tell Me Something : Ana
Groove Is In The Heart : Deee-Lite
Hard To Handle : The Black Crowes
Heart : Neneh Cherry
Heart Like A Wheel : The Human League
Heart Of Stone : Cher
Heart Of Stone : Taylor Dayne
Heartbeat : Seduction
Heaven Is A 4 Letter Word : Bad English
Here And Now : Luther Vandross
Here We Are : Gloria Estefan
Hide And Seek : Pajama Party
High Enough : Damn Yankees
Hippychick : Soho
Hold On : En Vogue
Holding My Heart : Bang
House Of Broken Love : Great White
House Of Fire : Alice Cooper
House Of Pain : Faster Pussycat
How Bout Us (From "True Love") : Grayson Hugh
How Can We Be Lovers : Michael Bolton
Hungry : Lita Ford
Hurting Kind (I ve Got My Eyes On You) : Robert Plant
I Didn t Mean To Stay All Night : Starship
I Don t Have The Heart : James Ingram
I Don t Know : Michael Morales
I Don t Love You Anymore : The London Quireboys
I Found Love : The Party
I Live By The Groove : Paul Carrack
I Melt With You : Modern English
I Remember You : Skid Row
I Wanna Be Rich : Calloway
I Wanna Get With U : Guy
I Will Survive (From "She-Devil") : SaFire
I Won t Give Up On You : TKA
I d Rather Go Blind : Sydney Youngblood
I ll Be Good To You : Quincy Jones Featuring Ray Charles
I ll Be There : Joyce "Fenderella" Irby
I ll See You In My Dreams : Giant
I m Free : The Soup Dragons
I m Not In Love : Will To Power
I m Not Satisfied : Fine Young Cannibals
I m Your Baby Tonight : Whitney Houston
Ice Ice Baby : Vanilla Ice
If U Were Mine : The U-Krew
If You Leave Me Now : Jaya
If You Needed Somebody : Bad Company
Imagination : Xymox
Impulsive : Wilson Phillips
Innocent : The Whispers
It Must Have Been Love (From "Pretty Woman") : Roxette
Jealous : Gene Loves Jezebel
Jerk Out : The Time
Joey : Concrete Blonde
Just A Friend : Biz Markie
Just Another Dream : Cathy Dennis
King Of Wishful Thinking (From "Pretty Woman") : Go West
Kiss This Thing Goodbye : Del Amitri
Knockin Boots : Candyman
La Raza : Kid Frost
Lambada : Kaoma
Let Love Rule : Lenny Kravitz
Let s Try It Again : New Kids On The Block
Livin In The Light : Caron Wheeler
Living In Oblivion : Anything Box
Living In Sin : Bon Jovi
Look Into My Eyes : George LaMond
Lost Soul : Bruce Hornsby
Love Is : Alannah Myles
Love Is A Killer : Vixen
Love Is A Rock : REO Speedwagon
Love Is The Ritual : Styx
Love Me Just For Me : Special Generation
Love Takes Time : Mariah Carey
Lyin To Myself : David Cassidy
Make It Like It Was : Regina Belle
Make You Sweat : Keith Sweat
Me So Horny : The 2 Live Crew
Me-U=Blue : Glenn Medeiros (Featuring The Stylistics)
Mentirosa : Mellow Man Ace
Miles Away : Winger
Miracle (From "Young Guns II") : Jon Bon Jovi
Missunderstanding : Al B. Sure!
Moneytalks : AC/DC
Moonlight On Water : Laura Branigan
More Than Words Can Say : Alias
My Love Is A Fire : Donny Osmond
Never Enough : The Cure
New Power Generation : Prince
New York Minute : Don Henley
Nicety : Michel le
Nick Of Time : Bonnie Raitt
No Matter What : George LaMond (Duet With Brenda K. Starr)
Nothin To Hide : Poco
Nothing Compares 2 U : Sinead O Connor
Notice Me : Nikki
Now You re Gone : Whitesnake
Oh Girl : Paul Young
On The Way Up : Elisa Fiorillo
One And Only Man : Steve Winwood
One More Try : Timmy T.
Only Women Bleed : Favorite Angel
Ooh La La (I Can t Get Over You) : Perfect Gentlemen
Ooops Up : Snap
Opposites Attract : Paula Abdul (Duet With The Wild Pair)
Owwww! : Chunky A
Peace In Our Time : Eddie Money
Policy Of Truth : Depeche Mode
Pray : M.C. Hammer
Precious Love : Jody Watley
Pure : Lightning Seeds
Real Love : Skyy
Right And Hype : Abstrac
Rock Wit cha : Bobby Brown
Romeo : Dino
Room At The Top : Adam Ant
Round And Round : Tevin Campbell
Same Old Look : Jimmy Ryser
Save Me : Fleetwood Mac
Say A Prayer : Breathe
Sending All My Love : Linear
Sensitivity : Ralph Tresvant
Serious Kinda Girl : Christopher Max
Shake : Andrew Ridgeley
She Ain t Worth It : Glenn Medeiros Featuring Bobby Brown
Shelter Me : Cinderella
Show Me : Howard Hewett
Sittin In The Lap Of Luxury : Louie Louie
Slow Love : Doc Box
So Close : Daryl Hall John Oates
So Hard : Pet Shop Boys
Something Happened On The Way To Heaven : Phil Collins
Something To Believe In : Poison
Soul Inspiration : Anita Baker
Spin That Wheel : Hi Tek 3 Featuring Ya Kid K
Steamy Windows : Tina Turner
Stranded : Heart
Stranger To Love : St. Paul
Suicide Blonde : INXS
Summer Rain : Belinda Carlisle
Swing The Mood : Jive Bunny
Take It To Heart : Michael McDonald
Talk To Myself : Christopher Williams
Tell Me Something : Indecent Obsession
That s The Way Of The World : D-Mob With Cathy Dennis
The Arms Of Orion : Prince (With Sheena Easton)
The Ballad Of Jayne : L.A. Guns
The Boomin System : LL Cool J
The First Time : Surface
The Ghetto : Too Short
The Girl I Used To Know : Brother Beyond
The Humpty Dance : Digital Underground
The Obvious Child : Paul Simon
The Right Combination : Seiko
The Secret Garden : Quincy Jones
The Swalk : Notorious
The Way It Is : Tesla
The Way You Do The Things You Do : UB40
There s A Party Going On : Yvonne
Think : Information Society
This : Michael Penn
This House : Tracie Spencer
This Is Ponderous : 2nu
This Is The Right Time : Lisa Stansfield
This Old Heart Of Mine : Rod Stewart With Ronald Isley
Tic-Tac-Toe : Kyper
Tick Tock : Vaughan Brothers
Time After Time : Timmy T
Time For Letting Go : Jude Cole
Timeless Love (From "Shocker") : Saraya
Tom s Diner : DNA Featuring Suzanne Vega
Tomorrow (A Better You, Better Me) : Quincy Jones With Tevin Campbell
Too Hot : Loverboy
True Blue Love : Lou Gramm
Try To Find Me : Gorky Park
Turtle Power : Partners In Kryme
Unchained Melody : Righteous Brothers
Undeniable : Ms. Adventures
Use It Up And Wear It Out : Pat
Violence Of Summer (Love s Taking Over) : Duran Duran
Vogue : Madonna
Wait For You : Bonham
Walk On By : Sybil
Was It Nothing At All : Michael Damian
We re All In the Same Gang : The West Coast Rap All-Stars
What It Takes : Aerosmith
What Kind Of Man Would I Be? : Chicago
Whatcha Gonna Do With My Lovin : Inner City
When I Dream Of You : Tommy Page
When Something Is Wrong With My Baby : Linda Ronstadt/Aaron Neville
When The Night Comes : Joe Cocker
Where Does My Heart Beat Now : Celine Dion
Wherever Would I Be : Cheap Trick
Whip Appeal : Babyface
Whole Wide World (From "True Love") : A me Lorain
Wicked Game : Chris Isaak
Wiggle It : 2 In A Room
Wild Women Do (From "Pretty Woman") : Natalie Cole
Without You : Motley Crue
Woman In Chains : Tears For Fears
Won t Talk About It : Beats International
You Can t Get Away : Shana
You Make Me Feel (Mighty Real) : Jimmy Somerville
You re Amazing : Robert Palmer
You re The Only Woman : The Brat Pack
You re The Voice : John Farnham
Your Baby Never Looked Good In Blue : Expose
