(Everything I Do) I Do It For You (From "Robin Hood") : Bryan Adams
3 A.M. Eternal : The KLF
6 Minutes Of Pleasure : LL Cool J
After The Summer s Gone : PC Quest
Ain t Gonna Hurt Nobody : Kid N Play
Ain t No Future In Yo Fronting : M.C. Breed
Ain't Gonna Hurt Nobody : Kid 'N Play
Ain't No Future In Yo' Fronting : M.C. Breed & D.F.C.
All About You : Pretty In Pink
All I Need Is You : Blue Train
All This Time : Sting
All Through The Night : Tone-Loc
All True Man : Alexander O Neal
And So It Goes : Billy Joel
Angel Baby : Angelica
Another Sleepless Night : Shawn Christopher
Anything Is Possible : Debbie Gibson
Baby s Coming Back : Jellyfish
Backyard : Pebbles (With Salt-N-Pepa)
Ballad Of Youth : Richie Sambora
Because I Love You (The Postman Song) : Stevie B
Black Or White : Michael Jackson
Borrowed Love : Bingo Boys
Break Up To Make Up : Cynthia
Call It Rock N Roll : Great White
Can You Stop The Rain : Peabo Bryson
Can t Truss It : Public Enemy
Candy : Iggy Pop With Kate Pierson
Change : Lisa Stansfield
Chasin The Wind : Chicago
Chorus : Erasure
Close To Me : The Cure
Coming Out Of The Dark : Gloria Estefan
Conviction Of The Heart : Kenny Loggins
Crash (Have Some Fun) : TKA Featuring Michelle Visage
Crazy : Daisy Dee
Crazy : Seal
Cry For Help : Rick Astley
Deep, Deep Trouble : The Simpsons Featuring Bart
Deeper Shade Of Soul : Urban Dance Squad
Dirty Love : Thunder
Disappear : INXS
Do Anything : Natural Selection
Do You Feel Like I Feel? : Belinda Carlisle
Does Anybody Really Fall In Love Anymore? : Kane Roberts
Does She Love That Man? : Breathe Featuring David Glasper
Don t Hold Back Your Love : Daryl Hall John Oates
Don t Let The Sun Go Down On Me : George Michael/Elton John
Don t Want To Be A Fool : Luther Vandross
Don't Cry : Guns N' Roses
Double Good Everything : Smokey Robinson
Dream Lover : The Rebel Pebbles
Elevate My Mind : Stereo MC s
Emotions : Mariah Carey
Enter Sandman : Metallica
Every Heartbeat : Amy Grant
Everybody Plays The Fool : Aaron Neville
Everyotherday : Or-N-More (Featuring Father M.C.)
Exclusivity : Damian Dame
Face The Music : RTZ
Fading Like A Flower (Every Time You Leave) : Roxette
Fairweather Friend : Johnny Gill
Fall At Your Feet : Crowded House
Feel The Groove : Cartouche
Finally : CeCe Peniston
For You : The Outfield
Forever Amo r : D zyre
Forever My Lady : Jodeci
Freedom : George Michael
From A Distance : Bette Midler
Funk Boutique : The Cover Girls
Gentle : Dino
Get A Leg Up : John Mellencamp
Get Here : Oleta Adams
Get Serious : Cut N Move
Gett Off : Prince And The N.P.G.
Give It Away : Red Hot Chili Peppers
Give It To Me Good : Trixter
Give It Up : ZZ Top
Give Peace A Chance : The Peace Choir
Go For It! (Heart And Fire) : Joey B. Ellis
Going Through The Motions : Aftershock
Gonna Catch You (From "Cool As Ice") : Lonnie Gordon
Good Heart : Starship
Good Time : Ziggy Marley
Good Vibrations : Marky Mark
Good Vibrations : Marky Mark & The Funky Bunch Featuring Loleatta Holloway
Got A Love For You : Jomanda
Gotta Have You (From "Jungle Fever") : Stevie Wonder
Groove Is In The Heart : Deee-Lite
Groovy Train : The Farm
Gypsy Woman (She s Homeless) : Crystal Waters
Hang In Long Enough : Phil Collins
Hard To Handle : The Black Crowes
Heat Of The Moment : After 7
Heaven In The Back Seat : Eddie Money
Here Comes The Hammer : M.C. Hammer
Here We Go : C+C Music Factory/F. Williams
Hey Donna : Rhythm Syndicate
Hey Stoopid : Alice Cooper
High Enough : Damn Yankees
Higher Than Hope : Daryl Braithwaite
Highwire : The Rolling Stones
Hippychick : Soho
Hold You Tight : Tara Kemp
Hole Hearted : Extreme
Home Sweet Home : Motley Crue
House Full Of Reasons : Jude Cole
Housecall : Shabba Ranks (Featuring Maxi Priest)
Housecall : Shabba Ranks/Maxi Priest
How Much Is Enough : The Fixx
How To Dance : Bingo Boys Featuring Princessa
I Adore Mi Amor : Color Me Badd
I Can t Wait Another Minute : Hi-Five
I Don t Have The Heart : James Ingram
I Don t Know Anybody Else : Black Box
I Don t Wanna See You : Michael Morales
I Don t Want To Lose Your Love : B Angie B
I Love Your Smile : Shanice
I Saw Red : Warrant
I Touch Myself : Divinyls
I Wanna Get With U : Guy
I Want You : Jody Watley
I Wonder Why : Curtis Stigers
I ll Be There : The Escape Club
I ll Do 4 U : Father M.C.
I ll Give All My Love To You : Keith Sweat
I m Dreamin (From "New Jack City") : Christopher Williams
I m Not In Love : Will To Power
I m Not Your Puppet : Hi-C
I m Too Sexy : Right Said Fred
I ve Been Thinking About You : Londonbeat
I ve Been Waiting For You : Guys Next Door
I ve Got A Lot To Learn About Love : The Storm
Iesha : Another Bad Creation
If I Say : Kingofthehill
If You re Serious : Riff
Impulsive : Wilson Phillips
In Paradise : Laissez Faire
In Your Arms : Little Caesar
Is It Good To You : Heavy D & The Boyz
It Ain t Over Til It s Over : Lenny Kravitz
It Hit Me Like A Hammer : Huey Lewis
It Never Rains (In Southern California) : Tony Toni Tone
It s A Shame (My Sister) : Monie Love
Jealousy : The Adventures Of Stevie V
Joey : Concrete Blonde
Just A Little Bit Longer : Maxi Priest
Just A Touch Of Love : C+C Music Factory Presents Zelma Davis
Just Like You : Robbie Nevil
Just The Way It Is, Baby : The Rembrandts
Just Want To Hold You : Jasmine Guy
Justify My Love : Madonna
Keep Coming Back : Richard Marx
Keep Warm : Jinny
Kiss Them For Me : Siouxsie
Kiss You Back : Digital Underground
Kisses In The Night : Brandon
Kissing You : Keith Washington
Latin Active : Lighter Shade Of Brown Featuring Teardrop
Learning To Fly : Tom Petty And The Heartbreakers
Let The Beat Hit Em : Lisa Lisa
Let s Talk About Sex : Salt-N-Pepa
Lift Me Up : Yes
Lily Was Here : David A. Stewart Introducing Candy Dulfer
Louder Than Love : TKA
Love And Understanding : Cher
Love Crazy : Atlantic Starr
Love Desire : Sandee
Love Gets Rough : Troy Newman
Love Makes Things Happen : Pebbles
Love Me All Up : Stacy Earl
Love Me Forever Or Love Me Not : Trilogy
Love Of A Lifetime : Firehouse
Love On A Rooftop : Desmond Child
Love Will Never Do (Without You) : Janet Jackson
Love. . .Thy Will Be Done : Martika
Low Rider (On The Boulevard) : Latin Alliance Featuring War
Lyin To Myself : David Cassidy
Made Up My Mind : SaFire
Melt In Your Mouth : Candyman
Miles Away : Winger
Mind Playing Tricks On Me : Geto Boys
Miracle (From "Young Guns II") : Jon Bon Jovi
Missunderstanding : Al B. Sure!
Moneytalks : AC/DC
Monster : Fred Schneider
Monsters And Angels : Voice Of The Beehive
Motownphilly : Boyz II Men
Move Any Mountain : The Shamen
My Body Says Yes : Titiyo
My Fallen Angel : Coro
My Heart Belongs To You : Russ Irwin
My Name Is Not Susan : Whitney Houston
My Side Of The Bed : Susanna Hoffs
Never Stop : The Brand New Heavies Feat. N Dea Davenport
New Jack Hustler (Nino s Theme) (From "New Jack City") : Ice-T
New York Minute : Don Henley
No Matter What : George LaMond (Duet With Brenda K. Starr)
No More Tears : Ozzy Osbourne
No Son Of Mine : Genesis
Now That We Found Love : Heavy D
O.P.P. : Naughty By Nature
On A Sunday Afternoon : Lighter Shade Of Brown
On The Way Up : Elisa Fiorillo
One And Only Man : Steve Winwood
One More Try : Timmy T.
Only Time Will Tell : Nelson
Ooh La La : David Hallyday
Part Of Me, Part Of You : Glenn Frey
People Are Still Having Sex : LaTour
Place In This World : Michael W. Smith
Play That Funky Music : Vanilla Ice
Pop Goes The Weasel : 3rd Bass
Pop That Coochie : The 2 Live Crew
Power Windows : Billy Falcon
Pump It (Nice An Hard) : Icy Blu
Real Real Real : Jesus Jones
Remember My Name : House Of Lords
Rico Suave : Gerardo
Ring My Bell : D.J. Jazzy Jeff & The Fresh Prince
Romantic : Karyn White
Round And Round : Tevin Campbell
Running Back To You : Vanessa Williams
Rush : Big Audio
Sadeness Part 1 : Enigma
Save Me : Lisa Fischer
Save Some Love : Keedy
See The Lights : Simple Minds
Sensitivity : Ralph Tresvant
Set Adrift On Memory Bliss : P.M. Dawn
Set The Night To Music : Roberta Flack With Maxi Priest
Shake It (Like A White Girl) : Jesse Jaymes
She s Gone (Lady) : Steelheart
Shelter Me : Cinderella
Shiny Happy People : R.E.M.
Shot Of Poison : Lita Ford
Show Me The Way : Styx
Signs : Tesla
Silent Lucidity : Queensryche
Silver Thunderbird : Marc Cohn
Skat Strut : MC Skat Kat
Smells Like Teen Spirit : Nirvana
Something Got Me Started : Simply Red
Something In My Heart : Michel le
Something To Believe In : Poison
Something To Talk About : Bonnie Raitt
Sometimes (It s A Bitch) : Stevie Nicks
Spend My Life : Slaughter
Step On : Happy Mondays
Still Got The Blues : Gary Moore
Straight To Your Heart : Bad English
Stranded : Heart
Street Of Dreams : Nia Peeples
Summertime : D.J. Jazzy Jeff
Superman s Song : Crash Test Dummies
Sure Lookin : Donny Osmond
Temple Of Love : Harriet
Temptation : Corina
That s The Way Love Goes : Young MC
That s Why : The Party
The Devil Came Up To Michigan : K.M.C. KRU
The First Time : Surface
The Fly : U2
The Ghetto : Too Short
The Motown Song : Rod Stewart
The Obvious Child : Paul Simon
The One And Only : Chesney Hawkes
The Promise Of A New Day : Paula Abdul
The Real Love : Bob Seger
The Sound Of Your Voice : 38 Special
The Swalk : Notorious
The Truth : Tami Show
The Way You Do The Things You Do : UB40
Then Came You : T.P.E.
There She Goes : The La s
Things That Make You Go Hmmmm... : C+C Music Factory
Think : Information Society
Thinking Of You : Grandmaster Slice
This Beat Is Hot : B.G. The Prince Of Rap
This House : Tracie Spencer
This Is Ponderous : 2nu
Till Somebody Loves You : Henry Lee Summer
Time, Love And Tenderness : Michael Bolton
To Be With You : Mr. Big
Together Forever : Lisette Melendez
Tom s Diner : DNA Featuring Suzanne Vega
Tonite : DJ Quik
Too Blind To See It : Kym Sims
Too Many Walls : Cathy Dennis
Top Of The World : Van Halen
Treat Em Right : Chubb Rock
Try A Little Tenderness : The Commitments
Turn It Up : Oaktown s 3.5.7
Unbelievable : EMF
Unchained Melody : Righteous Brothers
Unforgettable : Natalie Cole
Use It Up And Wear It Out : Pat
Voices That Care : Voices That Care
Waiting For Love : Alias
Walk Through Fire : Bad Company
Wanna Dance : Yasmin
What A Price To Pay : Michael Damian
What Comes Naturally : Sheena Easton
What s It Gonna Be : Jellybean Featuring Niki Haris
When Love Cries : Donna Summer
When Will I See You Smile Again? : Bell Biv Devoe
Where Does My Heart Beat Now : Celine Dion
Where The Streets Have No Name : Pet Shop Boys
Why Can t You Come Home : Ex-Girlfriend
Wicked Game : Chris Isaak
Wiggle It : 2 In A Room
Wildside : Marky Mark & The Funky Bunch
Wind Of Change : Scorpions
With You : Tony Terry
Within My Heart : Voyce
Word Of Mouth : Mike
Word To The Badd!! : Jermaine Jackson
World In My Eyes : Depeche Mode
Written All Over Your Face : The Rude Boys
You Can t Play With My Yo-Yo : Yo-Yo Featuring Ice Cube
You Could Be Mine : Guns N Roses
You Don t Have To Go Home Tonight : The Triplets
You Gotta Love Someone : Elton John
You re Amazing : Robert Palmer
