(I Know I Got) Skillz : Shaquille O Neal
(I Know I Got) Skillz : Shaquille O'Neal
360 Degrees (What Goes Around) : Grand Puba
7 : Prince And The New Power Generation
93 'Til Infinity : Souls Of Mischief
A Bad Goodbye : Clint Black With Wynonna
A Whole New World (Aladdin s Theme) : Peabo Bryson
ABC-123 : Levert
Alibis : Tracy Lawrence
All Alone On Christmas (From "Home Alone 2") : Darlene Love
All For Love : Bryan Adams/Rod Stewart/Sting
All That She Wants : Ace Of Base
Almost Unreal (From "Super Mario Bros.") : Roxette
Alright : Kris Kross Featuring Supercat
Another Sad Love Song : Toni Braxton
Award Tour : A Tribe Called Quest
Baby I m For Real/Natural High : After 7
Baby I m Yours : Shai
Baby, I Believe In You : George LaMond
Back Seat (Of My Jeep) : LL Cool J
Beautiful Girl : INXS
Believe : Lenny Kravitz
Betcha'll Never Find : Chantay Savage
Better Than You : Lisa Keith
Big Gun (From "Last Action Hero") : AC/DC
Boom! Shake The Room : Jazzy Jeff
Born 2 B.R.E.E.D. : Monie Love
Both Sides Of The Story : Phil Collins
Bow Wow Wow : Funkdoobiest
Break It Down Again : Tears For Fears
Breakadawn : De La Soul
Buddy X : Neneh Cherry
By The Time This Night Is Over : Kenny G With Peabo Bryson
Can We Talk : Tevin Campbell
Can t Get Enough Of Your Love : Taylor Dayne
Can t Help Falling In Love (From "Sliver") : UB40
Candy Everybody Wants : 10,000 Maniacs
Cannonball : The Breeders
Cantaloop (Flip Fantasia) : US 3
Cat s In The Cradle : Ugly Kid Joe
Chains Around My Heart : Richard Marx
Chattahoochee : Alan Jackson
Check Yo Self : Ice Cube Featuring Das EFX
Chief Rocka : Lords Of The Underground
Closer : Remedy
Come Baby Come : K7
Come In Out Of The Rain : Wendy Moten
Come Inside : Intro
Come Undone : Duran Duran
Commitment Of The Heart : Clive Griffin
Crazy Love : CeCe Peniston
Creep : Radiohead
Cry No More : II D Extreme
Cryin : Aerosmith
Dazzey Duks : Duice
Dedicated : R. Kelly
Deeper : Boss
Delicate : Terence Trent D Arby
Ditty : Paperboy
Do Da What : 1 Of The Girls
Don t Take Away My Heaven : Aaron Neville
Down With The King : Run-D.M.C.
Dreamlover : Mariah Carey
Dreams : Gabrielle
Dur Dur D etre BeBe! (It s Tough To Be A Baby) : Jordy
Easy : Faith No More
Easy Come, Easy Go : George Strait
Even A Fool Can See : Peter Cetera
Every Little Thing U Do : Christopher Williams
Everybody Hurts : R.E.M.
Everything s Gonna Be Alright : Father M.C.
Faithful : Go West
Falling In Love : New Born
Fast As You : Dwight Yoakam
Feed The Tree : Belly
Feels Like Heaven : Peter Cetera (Duet With Chaka Khan)
Fields Of Gold : Sting
Fields Of Gray : Bruce Hornsby
Flex : Mad Cobra
Flow Joe : Fat Joe
For The Cool In You : Babyface
Foreplay : RAab
Forever In Love : Kenny G
Freakit : Das EFX
Games : Chuckii Booker
Gangsta Bitch : Apache
Gangsta Lean : DRS
Get Away : Bobby Brown
Get It Up (From "Poetic Justice") : TLC
Get Up (Move Boy Move) : AB Logic
Getto Jam : Domino
Girl U For Me/Lose Control : Silk
Girl, I ve Been Hurt : Snow
Give Him A Love He Can Feel : Tene Williams
Give It To You : Martha Wash
Give It Up : The Goodmen
Give It Up, Turn It Loose : En Vogue
Gold Diggin Girls : MC Nas-D
Goody Goody : Lisette Melendez
Gotta Get Mine : M.C. Breed
Happenin' All Over Again : Lonnie Gordon
Happy : Legacy Of Sound Featuring Meja
Heaven Knows : Luther Vandross
Here We Go Again! : Portrait
Hero : David Crosby
Hey Jealousy : Gin Blossoms
Hey Mr. D.J. : Zhane
Homies : Lighter Shade Of Brown
Hope Of Deliverance : Paul McCartney
Hopelessly : Rick Astley
How Do You Talk To An Angel : The Heights
Human Wheels : John Mellencamp
I Can See Clearly Now (From "Cool Runnings") : Jimmy Cliff
I Don t Care : Shakespear s Sister
I Don t Wanna Fight (From "What s Love Got To Do With It") : Tina Turner
I Feel You : Depeche Mode
I Get Around : 2Pac
I Got A Man : Positive K
I Got A Thang 4 Ya! : Lo-Key?
I Like It : Jomanda
I Love Music (From "Carlito's Way") : Rozalla
I Love The Way You Love Me : John Michael Montgomery
I Love You Period : Dan Baird
I See Your Smile : Gloria Estefan
I d Do Anything For Love (But I Won t Do That) : Meat Loaf
I ll Never Get Over You (Getting Over Me) : Expose
I ll Sleep When I m Dead : Bon Jovi
I m A Player : Too Short
I m Free : Jon Secada
I m Gonna Be (500 Miles) : The Proclaimers
I m Gonna Get You : Bizarre Inc
I m In A Philly Mood : Daryl Hall
I m In Luv : Joe
I'll Be Loving You : Collage
I'm Looking For The One (To Be With Me) : Jazzy Jeff & The Fresh Prince
I'm Real : Kris Kross
If : Janet Jackson
If I Could : Regina Belle
If I Had No Loot : Tony Toni Tone
In My Nature : Nuttin Nyce
In The Heart Of A Woman : Billy Ray Cyrus
In The Still Of The Nite (From "The Jacksons") : Boyz II Men
Indo Smoke (From "Poetic Justice") : Mista Grimm
Insane In The Brain : Cypress Hill
Into Your Arms : The Lemonheads
Irresistible : Cathy Dennis
It Was A Good Day : Ice Cube
It s Alright (From "South Central") : Classic Example
It s For You (From "The Meteor Man") : Shanice
It s Gonna Be A Lovely Day : The S.O.U.L. S.Y.S.T.E.M.
It s My Life : Dr. Alban
It s On : Naughty By Nature
Jessie : Joshua Kadison
John Deere Green : Joe Diffie
Just Kickin It : Xscape
Killer/Papa Was A Rollin Stone : George Michael
La La Love : Bobby Ross Avila
Lately : Jodeci
Layla : Eric Clapton
Let Me Ride : Dr. Dre
Let Me Roll : Scarface
Lick U Up : H-Town
Lights : Journey
Linger : The Cranberries
Losin Myself : Debbie Gibson
Lost In Your Eyes : The Jeff Healey Band
Love Can Move Mountains : Celine Dion
Love Is (From "Beverly Hills, 90210") : Vanessa Williams/Brian McKnight
Love Is On The Way : Saigon Kick
Love Me The Right Way : Rapination
Love No Limit : Mary J. Blige
Love U More : Sunscreem
Love s Taken Over : Chante Moore
Loving Arms : Darden Smith
Mary Jane's Last Dance : Tom Petty And The Heartbreakers
Mega Medley : Zapp
Method Man : Wu-Tang Clan
More And More : Captain Hollywood Project
Mr. Vain : Culture Beat
Mr. Wendal : Arrested Development
Murder She Wrote : Chaka Demus
Never A Time : Genesis
No Mistakes : Patty Smyth
No Ordinary Love : Sade
No Rain : Blind Melon
Oh Carolina : Shaggy
One Last Cry : Brian McKnight
One Woman : Jade
Ooh Child : Dino
Passin Me By : The Pharcyde
Passionate Kisses : Mary Chapin Carpenter
Paying The Price Of Love : Bee Gees
Pets : Porno For Pyros
Pick It Up : Home Team
Pink Cashmere : Prince
Please Forgive Me : Bryan Adams
Pleasure : The Soup Dragons
Punks Jump Up To Get Beat Down : Brand Nubian
Push The Feeling On : Nightcrawlers
Quality Time : Hi-Five
Rain : Madonna
Real Muthaphuckkin G's : Eazy-E
Reason To Believe : Rod Stewart
Rebirth Of Slick (Cool Like Dat) : Digable Planets
Rhythm Is A Dancer : Snap
Right Here (Human Nature)/Downtown : SWV
Right Now : Al B. Sure!
Roll Wit Tha Flava : The Flavor Unit MC s
Romeo : Dolly Parton
Rubberband Girl : Kate Bush
Ruffneck : MC Lyte
Rump Shaker : Wreckx-N-Effect
Run To You (From "The Bodyguard") : Whitney Houston
Runaway Love : En Vogue Featuring FMOB
Runaway Train : Soul Asylum
Same Ol' Shit : MC Ren
Save Your Love : Bad Boys Blue
Sesame s Treet : Smart E s
Sexual : Goddess
Shamrocks And Shenanigans (Boom Shalock Lock Boom) : House Of Pain
Shoop : Salt-N-Pepa
Shoop Shoop (Never Stop Givin You Love) : Michael Cooper
Should ve Been A Cowboy : Toby Keith
Show Me Love : Robin S.
Six Feet Deep : Geto Boys
Slam : Onyx
Sleeping Satellite : Tasmin Archer
Sleeping With You : Firehouse
Slow And Easy : Zapp & Roger
Slow And Sexy : Shabba Ranks (Featuring Johnny Gill)
So Alone : Men At Large
So Close : Dina Carroll
Somebody Love Me : Michael W. Smith
Someone To Hold : Trey Lorenz
Something In Your Eyes : Bell Biv Devoe
Something s Goin On : U.N.V.
Soul To Squeeze (From "Coneheads") : Red Hot Chili Peppers
Speed : Alpha Team
Stand : Poison
Stay Forever : Joey Lawrence
Stay Real : Erick Sermon
Steam : Peter Gabriel
Step It Up : Stereo MC s
Stop The World : Extreme
Streiht Up Menace (From "Menace II Society") : MC Eiht
Sunday Morning : Earth, Wind
Supermodel (You Better Work) : RuPaul
Sweat (A La La La La Long) : Inner Circle
Sweet Thing : Mick Jagger
Symphony Of Destruction : Megadeth
Tap The Bottle : Young Black Teenagers
Tarzan Boy (From "Teenage Mutant Ninja Turtles III") : Baltimora
Teddy Bear : G-Wiz
Tell Me What You Dream : Restless Heart Featuring Warren Hill
Tell Me Why : Wynonna
Tell The Truth : Jude Cole
That s What Little Girls Are Made Of : Raven-Symone
That s What Love Can Do : Boy Krazy
The Bonnie And Clyde Theme : Yo Yo
The Crying Game (From "The Crying Game") : Boy George
The Floor : Johnny Gill
The Last Song : Elton John
The Right Kind Of Love (From "Beverly Hills, 90210") : Jeremy Jordan
The River Of Dreams : Billy Joel
The Song Remembers When : Trisha Yearwood
The Ways Of The Wind : P.M. Dawn
This Could Be The One : Bad Company
Three Little Pigs : Green Jelly
Time And Chance : Color Me Badd
To Love Somebody : Michael Bolton
Toss-Up : N2Deep
Touch My Light : Big Mountain
True Love : Elton John & Kiki Dee
Two Princes : Spin Doctors
Two Steps Behind (From "Last Action Hero") : Def Leppard
Typical Reasons (Swing My Way) : Prince Markie Dee
U Don t Hear Me Tho : Rodney O
U.N.I.T.Y. : Queen Latifah
Understand This Groove : Sound Factory
Very Special : Big Daddy Kane Feat. Spinderella, L. Williams
Very Special : Big Daddy Kane Feat. Spinderella, L. Williams & K. Anderson
Voice Of Freedom : Freedom Williams
Walk On The Ocean : Toad The Wet Sprocket
Walking On Broken Glass : Annie Lennox
We Getz Busy : Illegal
What Is Love : Haddaway
What Might Have Been : Little Texas
What s Up : 4 Non Blondes
What s Up Doc? (Can We Rock) : Fu-Schnickens W/ Shaquille O Neal
What's It To You : Clay Walker
What's My Name? : Snoop Dogg
When I Fall In Love (From "Sleepless In Seattle") : Celine Dion And Clive Griffin
When She Cries : Restless Heart
Where You Goin Now : Damn Yankees
Who Got The Props : Black Moon
Who s Gonna Ride Your Wild Horses : U2
Whoomp! (There It Is) : Tag Team
Whoot, There It Is : 95 South
Wide River : Steve Miller Band
Wild World : Mr. Big
Will You Be There (From "Free Willy") : Michael Jackson
Will You Be There (In The Morning) : Heart
World (The Price Of Love) : New Order
Would I Lie To You? : Charles
Yesterdays : Guns N Roses
Yolanda : Reality
You re The Love Of My Life/The Love I Lost : Sybil
Your Love Keeps Working On Me : Jody Watley
