'Round We Go : Big Sister
1, 2, 3, 4 (Sumpin' New) : Coolio
5 O'Clock : Nonchalant
A Thin Line Between Love & Hate (From "A Thin Line...") : H-Town
ATLiens : OutKast
Ain't No Nigga/Dead Presidents : Jay-Z Featuring Foxxy Brown
Ain't No Playa : Rappin' 4-Tay
Ain't Nobody : Diana King
Ain't Nobody/Kissing You : Faith Evans
Ain't Nuthin' But A She Thing : Salt-N-Pepa
All Along : Blessid Union Of Souls
All Cried Out : Denine With Collage's Adam Marano
All I See : A+
All I Want : Susanna Hoffs
All The Things (Your Man Won't Do) (From "Don't Be A Menace...") : Joe
Always Be My Baby : Mariah Carey
Amish Paradise : Weird Al Yankovic
Angeline Is Coming Home : The Badlees
Anything : 3T
As I Lay Me Down : Sophie B. Hawkins
Ascension (Don't Ever Wonder) : Maxwell
At Night I Pray : Wild Orchid
Automatic Lover (Call For Love) : Real McCoy
Baby Luv : Groove Theory
Back For Good : Take That
Back To The World : Tevin Campbell
Barely Breathing : Duncan Sheik
Beware Of My Crew (From "A Thin Line Between Love And Hate") : L.B.C. Crew Feat. Tray D & South Sentrell
Beyond The Invisible : Enigma
Birmingham : Amanda Marshall
Bittersweet Me : R.E.M.
Blackberry Molasses : Mista
Blue : LeAnn Rimes
Bohemian Rhapsody (From "High School High") : The Braids
Boom Boom Boom : The Outhere Brothers
Bow Down : Westside Connection
Breakfast At Tiffany's : Deep Blue Something
C'mon N' Ride It (The Train) : Quad City DJ's
Can You Feel Me : Dru Down
Can't Be Really Gone : Tim McGraw
Can't Be Wasting My Time (From "Don't Be A Menace...") : Mona Lisa Featuring Lost Boyz
Can't Get You Off My Mind : Lenny Kravitz
Can't Knock The Hustle : Jay-Z
Caught A Lite Sneeze : Tori Amos
Celebration/Take Your Chance : Fun Factory
Chains : Tina Arena
Change The World (From "Phenomenon") : Eric Clapton
Children : Robert Miles
Closer To Free (From "Party Of Five") : Bodeans
Cold Rock A Party : MC Lyte
Cold World : Genius/GZA Featuring Inspektah Deck
Come See Me : 112
Count On Me (From "Waiting To Exhale") : Whitney Houston & CeCe Winans
Counting Blue Cars : Dishwalla
Cumbersome : Seven Mary Three
DJ Girl : Katalina
Dance Into The Light : Phil Collins
Danger : Blahzay Blahzay
Desperately Wanting : Better Than Ezra
Diggin' On You : TLC
Do You Miss Me : Jocelyn Enriquez
Do You Want To/Can't Hang : Xscape Featuring MC Lyte
Don't Let Go (Love) (From "Set It Off") : En Vogue
Don't Rush : Silk
Don't Wanna Lose You : Lionel Richie
Down Low (Nobody Has To Know) : R. Kelly Featuring Ronald Isley
Dreamer : Livin' Joy
Dreaming Of You : Selena
Drop : The Pharcyde
Energy : Devone
Envy/Firewater : Fat Joe
Esa Nena Linda : Artie The 1 Man Party
Ever Since You Went Away : Art N' Soul
Every Light In The House : Trace Adkins
Everybody Be Somebody : Ruffneck Featuring Yavahn
Everyday & Everynight : Yvette Michele
Everything Falls Apart/Small Wonders : dog's eye view
Falling : Montell Jordan
Fast Life : Kool G Rap
Fastlove : George Michael
Feel The Music : Planet Soul Featuring Brenda Dee
Feels So Good (Show Me Your Love) : Lina Santiago
Floatin' On Your Love : The Isley Brothers Featuring Angela Winbush
Flood : Jars Of Clay
Fly Like An Eagle (From "Space Jam") : Seal
Follow You Down/Til I Hear It From You : Gin Blossoms
Foolish Games/You Were Meant For Me : Jewel
For The Love Of You : Jordan Hill
Forever More : Puff Johnson
Free As A Bird : The Beatles
Friends : John Michael Montgomery
Fu-Gee-La : Fugees
Funkorama : Redman
Gangsta's Paradise (From "Dangerous Minds") : Coolio Featuring L.V.
Get Money : Junior M.A.F.I.A. Featuring The Notorious B.I.G.
Get On Up : Jodeci
Get Ready, Here It Comes (It's The Choo-Choo) : Southsyde B.O.I.Z.
Get Together : Big Mountain
Gettin' It : Too Short Feat. Parliament Funkadelic
Give Me One Reason : Tracy Chapman
Give Me...A Reason : Buffy
God Bless The Child : Shania Twain
Guilty (From "Seven") : Gravity Kills
Guys Do It All The Time : Mindy McCready
Hang 'Em High : Sadat X
Have I Never : A Few Good Men
Hay : Crucial Conflict
Heartspark Dollarsign : Everclear
Hero Of The Day : Metallica
High And Dry : Radiohead
Hook : Blues Traveler
Hoop In Yo Face (From "Sunset Park") : 69 Boyz Featuring Quad City DJ's
House Keeper : Men Of Vizion
How Could You (From "Bulletproof") : K-Ci & JoJo
How Do U Want It/California Love : 2Pac Featuring KC And JoJo
Hurricane : The Click
I Believe I Can Fly (From "Space Jam") : R. Kelly
I Believe In You And Me (From "The Preacher's Wife") : Whitney Houston
I Can Make It Better : Luther Vandross
I Don't Need Your Love : Angelina
I Don't Wanna Be Alone : Shai
I Fell In Love : Rockell
I Finally Found Someone (From "The Mirror Has Two Faces") : Barbra Streisand & Bryan Adams
I Like (From "The Nutty Professor") : Montell Jordan Featuring Slick Rick
I Like It : The Blackout Allstars
I Love You Always Forever : Donna Lewis
I Luv U Baby : The Original
I Remember : Boyz II Men
I Will Remember You (Live) : Sarah McLachlan
I Will Survive : Chantay Savage
I'll Be There For You/This House Is Not A Home : The Rembrandts
I'm Not Giving You Up : Gloria Estefan
I'm Still In Love With You : New Edition
If It Makes You Happy : Sheryl Crow
If We Fall In Love Tonight : Rod Stewart
If Your Girl Only Knew : Aaliyah
In The Meantime : Spacehog
Incarcerated Scarfaces/Ice Cream : Raekwon
Insensitive (From "Bed Of Roses") : Jann Arden
It Matters To Me : Faith Hill
It's A Party : Busta Rhymes Featuring Zhane
It's All Coming Back To Me Now : Celine Dion
It's Your Body : Johnny Gill Featuring Roger Troutman
Jellyhead : Crush
Jump On It : Sir Mix-A-Lot
Just A Girl : No Doubt
Just Between You And Me : dc Talk
Just Tah Let U Know : Eazy-E
Just The Way (Playas Play) : Alfonzo Hunter
Keep On, Keepin' On (From "Sunset Park") : MC Lyte Featuring Xscape
Key West Intermezzo (I Saw You First) : John Mellencamp
Knocks Me Off My Feet : Donell Jones
La Familia : Frost
Lady : D'Angelo
Last Night (From "The Nutty Professor") : Az Yet
Leavin' : The Tony Rich Project
Leflaur Leflah Eshkushka : Heltah Skeltah And O.G.C. As The Fab 5
Let's Get The Mood Right : Johnny Gill
Let's Lay Together (From "Don't Be A Menace...") : The Isley Brothers
Let's Make A Night To Remember : Bryan Adams
Let's Play House : Tha Dogg Pound Featuring Michel'le
Let's Ride : Richie Rich
Like I Do : For Real
Little Bitty : Alan Jackson
Live And Die For Hip Hop : Kris Kross
Loungin : LL Cool J
Lucky Love : Ace Of Base
Macarena (Bayside Boys Mix) : Los Del Rio
Macarena : Los Del Mar
Machinehead (From "Fear") : Bush
Magic Carpet Ride : The Mighty Dub Katz
Maria : Ricky Martin
Microphone Master : Das EFX (Featuring Mobb Deep)
Missing : Everything But The Girl
Missing You (From "Set It Off") : Brandy, Tamia, Gladys Knight & Chaka Khan
Missing You : Tina Turner
Mouth : Merril Bainbridge
Movin' On : CeCe Peniston
Mr. Ice Cream Man : Master P
Music Makes Me High : Lost Boyz
My Boo : Ghost Town DJ's
My Maria : Brooks & Dunn
Naked Eye : Luscious Jackson
Name : Goo Goo Dolls
Natural One (From "Kids") : Folk Implosion
Never Leave Me Alone : Nate Dogg Featuring Snoop Doggy Dogg
Never Too Busy : Kenny Lattimore
No Diggity : BLACKstreet (Featuring Dr. Dre)
No More Games : Skin Deep Featuring Li'l Kim Of Junior M.A.F.I.A.
No Time : Lil' Kim Featuring Puff Daddy
Nobody : Keith Sweat Featuring Athena Cage
Not A Dry Eye In The House : Meat Loaf
Not Gon' Cry (From "Waiting To Exhale") : Mary J. Blige
Nothin' But The Cavi Hit (From "Rhyme & Reason") : Mack 10 & Tha Dogg Pound
Nowhere To Go : Melissa Etheridge
Old Man & Me (When I Get To Heaven) : Hootie & The Blowfish
One And One : Robert Miles Featuring Maria Nayler
One By One : Cher
One For The Money : Horace Brown
One More Try : Kristine W
One Of Us : Joan Osborne
One Sweet Day : Mariah Carey & Boyz II Men
Only You : 112 Featuring The Notorious B.I.G.
Ooh Aah... Just A Little Bit : Gina G
Paparazzi : Xzibit
Peaches : The Presidents Of The United States Of America
Physical Funk : Domino
Please Don't Go : Immature
Po Pimp : Do Or Die (Featuring Twista)
Pony : Ginuwine
Pretty Girl : Jon B
Promises Broken : Soul Asylum
Ready To Go : Republica
Redneck Games : Jeff Foxworthy With Alan Jackson
Ridin' Low : L.A.D.
Roll To Me : Del Amitri
Runaway : Janet Jackson
Scarred (From "Eddie") : Luke
Scary Kisses : Voice Of The Beehive
Scent Of Attraction : Patra Duet With Aaron Hall
Set U Free : Planet Soul
Sexual Healing : Max-A-Million
Shadowboxin' : Genius/GZA Featuring Method Man
Shake A Lil' Somethin'... : The 2 Live Crew
Sittin' On Top Of The World : Da Brat
Sittin' Up In My Room (From "Waiting To Exhale") : Brandy
Slow Jams : Quincy Jones Feat. Babyface & Tamia With Portrai
Snapshot : RuPaul
So Many Ways (From "High School High") : The Braxtons
Solitude : Edwin McCain
Someday (From "The Hunchback Of Notre Dame") : All-4-One
Sometimes I Miss You So Much (Dedicated To The Christ Consciousness) : P.M. Dawn
Soul Food : Goodie Mob.
Stairway To Heaven : Pure Soul
Stayin' Alive : N-Trance
Steelo : 702
Strawberry Wine : Deana Carter
Street Dreams : Nas
Stupid Girl : Garbage
Sugar Honey Ice Tea : Goodfellaz
Superstar : Charm Farm
Sweet Dreams : La Bouche
Take A Look : J'Son
Tell Me (From "Eddie") : Dru Hill
Tell Me (I'll Be Around) : Shades
Tha Crossroads : Bone Thugs-N-Harmony
That Girl : Maxi Priest Featuring Shaggy
That Thing You Do! (From "That Thing You Do!") : The Wonders
That's How It Is (It's Like That) : Redman Featuring K-Solo
The 13th : The Cure
The Child (Inside) : Qkumba Zoo
The Earth, The Sun, The Rain : Color Me Badd
The Moment : Kenny G
The Riddler (From "Batman Forever") : Method Man
The Things That You Do : Gina Thompson
The World I Know : Collective Soul
The World Is A Ghetto : Geto Boys Featuring Flaj
Theme From Mission: Impossible (From "Mission: Impossible") : Adam Clayton & Larry Mullen
They Don't Care About Us : Michael Jackson
Thirty-Three : The Smashing Pumpkins
This Is For The Lover In You : Babyface Feat. LL Cool J, Howard Hewett, Jody Watley & Jef
This Is Your Night : Amber
Throw Your Hands Up : L.V.
Throw Your Set In The Air : Cypress Hill
Tonight Is The Night : Le Click
Touch Me Tease Me (From "The Nutty Professor") : Case Featuring Foxxy Brown
Touch Myself (From "Fled") : T-Boz
Tres Delinquentes : Delinquent Habits
Twisted : Keith Sweat
Un-Break My Heart : Toni Braxton
Use Your Heart : SWV
Visions Of A Sunset (From "Mr. Holland's Opus") : Shawn Stockman
Waiting For Wednesday : Lisa Loeb & Nine Stories
Walls (From "She's The One") : Tom Petty And The Heartbreakers
We Got It : Immature (Featuring Smooth)
We've Got It Goin' On : Backstreet Boys
What Kind Of Man Would I Be : Mint Condition
What's Love Got To Do With It (From "Supercop") : Warren G Featuring Adina Howard
When Boy Meets Girl : Total
When Love & Hate Collide : Def Leppard
When You Love A Woman : Journey
When You're Gone/Free To Decide : The Cranberries
Where Do U Want Me To Put It : Solo
Where Do We Go From Here (From "Eraser") : Vanessa Williams
Where Do You Go : No Mercy
Where Ever You Are : Terry Ellis
Where It's At : Beck
Who Can I Run To : Xscape
Who Do U Love : Deborah Cox
Who You Are : Pearl Jam
Why I Love You So Much/Ain't Nobody : Monica
Wishes (From "Kazaam") : Nathan Morris
With You : Somethin' For The People
Wonder : Natalie Merchant
Wonderwall : Oasis
Woo-Hah!! Got You All In Check/Everything Remains Raw : Busta Rhymes
Wu-Wear: The Garment Renaissance (From "High School High") : RZA Feat. Method Man & Cappadonna
You : Monifah
You Can Make History (Young Again) : Elton John
You Learn/You Oughta Know : Alanis Morissette
You Must Love Me (From "Evita") : Madonna
You Put A Move On My Heart : Quincy Jones Introducing Tamia
You Said : Mona Lisa
You Still Touch Me : Sting
Your Loving Arms : Billie Ray Martin
