(Now You See Me) Now You Don t : Lee Ann Womack
15 Minutes : Marc Nelson
24/7 : Kevon Edmonds
4, 5, 6 : Sole Featuring JT Money
4, 5, 6 : Sole Featuring JT Money & Kandi
808 : Blaque
A Bitter End : Deryl Dodd
A Night To Remember : Joe Diffie
All N My Grill : Missy "Misdemeanor" Elliott Featuring Big Boi
All Night Long : Faith Evans Featuring Puff Daddy
All Star : Smash Mouth
All That I Can Say : Mary J. Blige
All The Places (I Will Kiss You) : Aaron Hall
All Things Considered : Yankee Grey
Almost Doesn t Count : Brandy
Almost Home : Mary Chapin Carpenter
Amazed : Lonestar
American Woman : Lenny Kravitz
Angel Of Mine : Monica
Angels : Robbie Williams
Angels Would Fall : Melissa Etheridge
Another Way : Tevin Campbell
Anything But Down : Sheryl Crow
Anywhere : 112 Featuring Lil z
Are You That Somebody? : Aaliyah
At The Stars : Better Than Ezra
Auld Lang Syne : Kenny G
B-Please : Snoop Dogg Featuring Xzibit
Back 2 Good : matchbox 20
Back At One : Brian McKnight
Back That Thang Up : Juvenile Featuring Mannie Fresh
Back That Thang Up : Juvenile Featuring Mannie Fresh & Lil' Wayne
Bailamos : Enrique Iglesias
Beautiful Stranger : Madonna
Believe : Cher
Better Days (And The Bottom Drops Out) : Citizen King
Better Than Me : Terry Dexter
Big Big World : Emilia
Big Deal : LeAnn Rimes
Bills, Bills, Bills : Destiny s Child
Black Balloon : Goo Goo Dolls
Bling Bling : B.G. Featuring Baby, Turk, Mannie Fresh, Juvenile
Bling Bling : B.G. Featuring Baby, Turk, Mannie Fresh, Juvenile & Lil' Wayne
Bliss : Tori Amos
Blue (Da Ba Dee) : Eiffel 65
Blue Monday : Orgy
Boom, Boom, Boom, Boom!! : Vengaboys
Break Ups 2 Make Ups : Method Man Featuring D Angelo
Bug A Boo : Destiny's Child
Busy Man : Billy Ray Cyrus
C est La Vie : B*Witched
Can I Get A... : Jay-Z Featuring Amil (Of Major Coinz)
Can t Get Enough : Patty Loveless
Can t Get Enough : Willie Max Featuring Raphael Saadiq
Candy : Mandy Moore
Caught Out There : Kelis
Celebrity Skin : Hole
Changes : 2Pac
Chante s Got A Man : Chante Moore
Come And Get With Me : Keith Sweat Featuring Snoop Dogg
Cowboy : Kid Rock
Crazy Little Thing Called Love : Dwight Yoakam
Crush : Dave Matthews Band
Dancin' : Guy
Don t Say You Love Me : M2M
Drive Me Wild : Sawyer Brown
Everybody s Free (To Wear Sunscreen) : Baz Luhrmann
Everyone Falls In Love : Tanto Metro
Everything Is Everything : Lauryn Hill
Father Of Mine : Everclear
Fly (The Angel Song) : The Wilkinsons
For You I Will : Aaron Tippin
Fortunate : Maxwell
Genie In A Bottle : Christina Aguilera
Georgy Porgy : Eric Benet Featuring Faith Evans
Get Gone : Ideal
Get Involved : Raphael Saadiq
Get It On Tonite : Montell Jordan
Ghetto Cowboy : Mo Thugs Family Featuring Bone Thugs-N-Harmony
Girlfriend/Boyfriend : BLACKstreet With Janet
Give It To You : Jordan Knight
Give You What You Want (Fa Sure) : Chico DeBarge
God Must Have Spent A Little More Time On You : Alabama Featuring N Sync
Goodbye : Spice Girls
Got To Get It : Sisqo Featuring Make It Hot
Got Your Money : Ol Dirty Bastard Featuring Kelis
Got Your Money : Ol' Dirty Bastard Featuring Kelis
Guerrilla Radio : Rage Against The Machine
Ha : Juvenile
Hands : Jewel
Hands Of A Working Man : Ty Herndon
Hanginaround : Counting Crows
Happily Ever After : Case
Harmless : Mulberry Lane
Hate Me Now : NAS Featuring Puff Daddy
He Can't Love U : Jagged Edge
Heartbreak Hotel : Whitney Houston Feat. Faith Evans
Heartbreaker : Mariah Carey Featuring Jay-Z
Heavy : Collective Soul
Hey Leonardo (She Likes Me For Me) : Blessid Union Of Souls
Higher : Creed
Hold Me : Brian McKnight Featuring Tone
Hold On To Me : John Michael Montgomery
Holla Holla : Ja Rule
Home Alone : R. Kelly Featuring Keith Murray
Hooch : Everything
Hot Boyz : Missy "Misdemeanor" Elliott Featuring NAS, EVE
Hot Boyz : Missy "Misdemeanor" Elliott Featuring NAS, EVE & Q-Tip
Hot Spot : Foxy Brown
How Deep Is Your Love : Dru Hill Featuring Redman
How Do I Deal : Jennifer Love Hewitt
I Can t Get Over You : Brooks
I Could Not Ask For More : Edwin McCain
I Do (Cherish You) : 98 Degrees
I Don t Want To Miss A Thing : Aerosmith
I Don t Want To Miss A Thing : Mark Chesnutt
I Love You : Martina McBride
I Love You Came Too Late : Joey McIntyre
I Need To Know : Marc Anthony
I Still Believe : Mariah Carey
I Wanna Love You Forever : Jessica Simpson
I Want It All : Warren G Featuring Mack 10
I Want It That Way : Backstreet Boys
I Will Get There : Boyz II Men
I Will Go With You (Con Te Partiro) : Donna Summer
I Will Remember You (Live) : Sarah McLachlan
I ll Be Your Everything : Youngstown
I ll Go Crazy : Andy Griggs
I ll Still Love You More : Trisha Yearwood
I m Already Taken : Steve Wariner
I m Not Ready : Keith Sweat
If I Could Turn Back The Hands Of Time : R. Kelly
If You Could Read My Mind : Stars On 54: Ultra Nate, Amber, Jocelyn Enriquez
If You Had My Love : Jennifer Lopez
If You Love Me : Mint Condition
Inside Out : Eve 6
It Ain t My Fault 1 : Silkk The Shocker Featuring Mystikal
It s All About You (Not About Me) : Tracie Spencer
It s All Been Done : Barenaked Ladies
It s Not Right But It s Okay : Whitney Houston
It s Your Song : Garth Brooks
It s Your Thing : Mercedes Featuring Master P
Jamboree : Naughty By Nature Featuring Zhane
Jigga My N**** : Jay-Z
Jigga What... : Jay-Z Featuring Big Jaz
Jumper : Third Eye Blind
Keepin Up : Alabama
Kiss Me : Sixpence None The Richer
L.A. Song : Beth Hart
Last Kiss : Pearl Jam
Lately : Divine
Lately : Tyrese
Lean On Me : Kirk Franklin Feat. Mary J. Blige, Bono, R. Kelly, Crystal Lewis
Learn To Fly : Foo Fighters
Left & Right : D'Angelo Featuring Method Man And Redman
Left : D Angelo Featuring Method Man And Redman
Lesson In Leavin : Jo Dee Messina
Let Me Know : Cam Ron
Lightning Does The Work : Chad Brock
Little Good-Byes : SheDaisy
Little Man : Alan Jackson
Lonely And Gone : Montgomery Gentry
Lost In You : Garth Brooks as Chris Gaines
Love Me : 112 Featuring Mase
Lullaby : Shawn Mullins
Luv Me, Luv Me : Shaggy Featuring Janet
Mambo No. 5 (A Little Bit Of...) : Lou Bega
Maria : Blondie
Maybe Not Tonight : Sammy Kershaw
Meet Virginia : Train
Meeting In My Bedroom : Silk
Miami : Will Smith
Music Of My Heart : 'N Sync & Gloria Estefan
Music Of My Heart : N Sync
My Favorite Girl : Dave Hollister
My First Night With You : Mya
My Little Secret : Xscape
My Name Is : Eminem
My Own Worst Enemy : Lit
N 2 Gether Now : Limp Bizkit Featuring Method Man
NAS Is Like : NAS
Nann : Trick Daddy Featuring Trina
Never Been Kissed : Sherrie Austin
Never Gonna Let You Go : Faith Evans
Never There : Cake
No More Rain (In This Cloud) : Angie Stone
No Pigeons : Sporty Thievz Featuring Mr. Woods
No Place That Far : Sara Evans
Nobody s Supposed To Be Here : Deborah Cox
Nookie : Limp Bizkit
Notorious B.I.G. : The Notorious B.I.G. Featuring Puff Daddy
Notorious B.I.G. : The Notorious B.I.G. Featuring Puff Daddy & Lil' Kim
One Night Stand : J-Shin Featuring LaTocha Scott
Out Of My Head : Fastball
Players Holiday : T.W.D.Y. Featuring Too Short
Praise You : Fatboy Slim
Pretty Fly (For A White Guy) : The Offspring
Pushin Weight : Ice Cube Featuring Mr. Short Khop
Ready To Run : Dixie Chicks
Rosa Parks : OutKast
Ruff Ryders Anthem : DMX
Satisfy You : Puff Daddy Featuring R. Kelly
Save Tonight : Eagle-Eye Cherry
Scar Tissue : Red Hot Chili Peppers
Sexual (Li Da Di) : Amber
She s A Bitch : Missy "Misdemeanor" Elliott
She s All I Ever Had : Ricky Martin
She s In Love : Mark Wills
She s So High : Tal Bachman
Simon Says : Pharoahe Monch
Single White Female : Chely Wright
Sitting Home : Total
Slam Dunk : Five
Slave To The Habit : Shane Minor
Smile : Vitamin C Featuring Lady Saw
Smooth : Santana Featuring Rob Thomas
So Anxious : Ginuwine
Somebody s Out There Watching : The Kinleys
Someday : Sugar Ray
Someone You Used To Know : Collin Raye
Something Like That : Tim McGraw
Sometimes : Britney Spears
Southern Gul : Erykah Badu Featuring Rahzel
Special : Garbage
Spend My Life With You : Eric Benet Featuring Tamia
Spirit Of A Boy, Wisdom Of A Man : Randy Travis
Stay The Night : IMx
Steal My Sunshine : Len
Step To This : Master P Featuring D.I.G.
Still D.R.E. : Dr. Dre Featuring Snoop Dogg
Summer Girls : LFO
Sunshine : Coko
Sweetest Thing : U2
Take A Picture : Filter
Take Me There : BLACKstreet
Taking Everything : Gerald Levert
Talk Show Shhh! : Shae Jones
Tell Me It s Real : K-Ci
Tha Block Is Hot : Lil Wayne Featuring Juvenile
Tha Block Is Hot : Lil' Wayne Featuring Juvenile & B.G.
Thank God I Found You : Mariah Carey Featuring Joe
Thank God I Found You : Mariah Carey Featuring Joe & 98 Degrees
That s The Way It Is : Celine Dion
The Animal Song : Savage Garden
The Chanukah Song : Adam Sandler
The Chemicals Between Us : Bush
The Day The World Went Away : Nine Inch Nails
The Dolphin s Cry : Live
The Great Beyond : R.E.M.
The Greatest Romance Ever Sold : Prince
The Secret Of Life : Faith Hill
There You Have It : Blackhawk
Too Close : Next
Touch It : Monifah
Trippin : Total Featuring Missy Elliott
U Know What s Up : Donell Jones
Unbelievable : Diamond Rio
Unpretty : TLC
Unsent : Alanis Morissette
Vivrant Thing : Q-Tip
Wanna Be A Baller : Lil Troy Featuring Yungsta, Fat Pat, Lil Will, Hawk, Big T
Watch For The Hook : Cool Breeze Featuring OutKast, Goodie Mob
Watch Out Now : The Beatnuts Featuring Yellaklaw
We Can t Be Friends : Deborah Cox With R.L.
Westside : TQ
What It s Like : Everlast
What Ya Want : EVE
What d You Come Here For? : Trina
What s It Gonna Be?! : Busta Rhymes Featuring Janet
What s My Age Again? : Blink-182
Whatcha Wanna Do? : Mia X Featuring Charlie Wilson
When I Close My Eyes : Shanice
When I Said I Do : Clint Black
Where My Girls At? : 702
Wherever You Go : Voices Of Theory
Who Dat : JT Money Featuring Sole
Who Needs Pictures : Brad Paisley
Wild Wild West : Will Smith Featuring Dru Hill
Will 2K : Will Smith Featuring K-Ci
With You : Lila McCann
Woof : Snoop Dogg Featuring Mystikal And Fiend
Write This Down : George Strait
Written In The Stars : Elton John
Wrong Night : Reba
You : Jesse Powell
You Are Everything : Dru Hill
You Can Do It : Ice Cube Featuring Mack 10
You Can Do It : Ice Cube Featuring Mack 10 & Ms. Toi
You Get What You Give : New Radicals
You Got Me : The Roots Featuring Erykah Badu
You Had Me From Hello : Kenny Chesney
You ll Be In My Heart : Phil Collins
You re Beginning To Get To Me : Clay Walker
You re Easy On The Eyes : Terri Clark
You ve Got A Way : Shania Twain
