911 : Wyclef Jean Featuring Mary J. Blige
A Good Day To Run : Darryl Worley
A Little Gasoline : Terri Clark
A Long Walk : Jill Scott
AM To PM : Christina Milian
After Party : Koffee Brown
Again : Lenny Kravitz
Ain't Nothing `Bout You : Brooks & Dunn
Alive : P.O.D.
All For You : Janet
All Good? : De La Soul Featuring Chaka Khan
All Or Nothing : O-Town
Always On Time : Ja Rule Featuring Ashanti
Angel : Lionel Richie
Angel : Shaggy Featuring Rayvon
Angels In Waiting : Tammy Cochran
Area Codes : Ludacris Featuring Nate Dogg
Around The World (La La La La La) : ATC
Ashes By Now : Lee Ann Womack
Austin : Blake Shelton
Baby, Come Over (This Is Our Night) : Samantha Mumba
Babylon : David Gray
Bad Boy For Life : P. Diddy, Black Rob & Mark Curry
Ballin' Out Of Control : Jermaine Dupri Featuring Nate Dogg
Beautiful Day : U2
Because I Got High : Afroman
Best I Ever Had (Grey Sky Morning) : Vertical Horizon
Between Me And You : Ja Rule Featuring Christina Milian
Bia' Bia' : Lil Jon & The East Side Boyz Featuring Ludacris, Too Short, Big Kap & Chyna Whyte
Bizounce : Olivia
Bounce With Me : Lil Bow Wow Featuring Xscape
Bouncin' Back (Bumpin' Me Against The Wall) : Mystikal
Bouncing Off The Ceiling (Upside Down) : A*Teens
Bow Wow (That's My Name) : Lil Bow Wow
Break Ya Neck : Busta Rhymes
Breathless : The Corrs
Bring On The Rain : Jo Dee Messina With Tim McGraw
Brotha : Angie Stone
Burn : Jo Dee Messina
But For The Grace Of God : Keith Urban
Butterfly : Crazy Town
By Your Side : Sade
Can't Believe : Faith Evans Featuring Carl Thomas
Can't Deny It : Fabolous Featuring Nate Dogg
Can't Fight The Moonlight : LeAnn Rimes
Caramel : City High Featuring Eve
Castles In The Sky : Ian Van Dahl Featuring Marsha
Cha-Cha Slide : Mr. C The Slide Man
Change The Game : Jay-Z, Beanie Sigel And Memphis Bleek
Chickenhead : Project Pat
Clint Eastwood : Gorillaz
Complicated : Carolyn Dawn Johnson
Contagious : The Isley Brothers Featuring Ronald Isley AKA Mr. Biggs
Control : Puddle Of Mudd
Could It Be : Jaheim
Crazy : K-Ci & JoJo
Crazy For This Girl : Evan And Jaron
Cross The Border : Philly's Most Wanted
Dance With Me : Debelah Morgan
Danger (Been So Long) : Mystikal Featuring Nivea
Diddy : P. Diddy Featuring The Neptunes
Do U Wanna Roll (Dolittle Theme) : R.L., Snoop Dogg & Lil' Kim
Don't Happen Twice : Kenny Chesney
Don't Mess With The Radio : Nivea
Don't Talk : Jon B
Don't Talk : Jon B.
Don't Think I'm Not : Kandi
Don't You Forget It : Glenn Lewis
Dream On : Depeche Mode
Drive : Incubus
Drops Of Jupiter (Tell Me) : Train
E.I. : Nelly
Emotional : Carl Thomas
Every Other Time : LFO
Everybody Doesn't : Amanda
Everywhere : Michelle Branch
Fallin' : Alicia Keys
Family Affair : Mary J. Blige
Fat Lip : Sum 41
Fatty Girl : Ludacris, LL Cool J & Keith Murray
Feelin' On Yo Booty : R. Kelly
Feels Like Love : Vince Gill
Fiesta : R. Kelly Featuring Jay-Z
Fill Me In : Craig David
Flavor Of The Weak : American Hi-Fi
Follow Me : Uncle Kracker
Free : Mya
Freedom : Paul McCartney
Get Crunked Up : Iconz Featuring Tony Manshino
Get Over Yourself : Eden's Crush
Get Ur Freak On : Missy "Misdemeanor" Elliott
Girl Next Door : Musiq Soulchild Featuring Ayana
Girl Next Door : Musiq Soulchild Featuring Ayana Of Aaries
Girls Dem Sugar : Beenie Man Featuring Mya
God Bless America : Daniel Rodriguez
God Bless The USA : Lee Greenwood
Good Morning Beautiful : Steve Holy
Got Ur Self A... : Nas
Grown Men Don't Cry : Tim McGraw
Guilty Until Proven Innocent : Jay-Z Featuring R. Kelly
Hanging By A Moment : Lifehouse
Heard It All Before : Sunshine Anderson
Hemorrhage (In My Hands) : Fuel
Here's To The Night : Eve 6
Hero : Enrique Iglesias
Hey Baby : No Doubt Featuring Bounty Killer
Hit 'Em Up Style (Oops!) : Blu Cantrell
How Many Licks? : Lil' Kim Featuring Sisqo
How You Remind Me : Nickelback
I Could Not Ask For More : Sara Evans
I Cry : Ja Rule Featuring Lil' Mo
I Do!! : Toya
I Hope You Dance : Lee Ann Womack With Sons Of The Desert
I Just Wanna Love U (Give It 2 Me) : Jay-Z
I Know : Sunday
I Like Them Girls : Tyrese
I Wanna Be Bad : Willa Ford
I Would've Loved You Anyway : Trisha Yearwood
I'll Fly With You (L'amour Toujours) : Gigi D'Agostino
I'm A Believer : Smash Mouth
I'm A Survivor : Reba
I'm A Thug : Trick Daddy
I'm Already There : Lonestar
I'm Like A Bird : Nelly Furtado
I'm Real : Jennifer Lopez Featuring Ja Rule
I'm Tryin' : Trace Adkins
If I Fall You're Going Down With Me : Dixie Chicks
If You Can Do Anything Else : George Strait
If You're Gone : matchbox twenty
Imitation Of Life : R.E.M.
Irresistible : Jessica Simpson
Is That Your Chick : Memphis Bleek Featuring Jay-Z & Missy Elliott
It Wasn't Me : Shaggy Feat. Ricardo "RikRok" Ducent
It Wasn't Me : Shaggy Featuring Ricardo "RikRok" Ducent
It's A Great Day To Be Alive : Travis Tritt
It's Been Awhile : Staind
Jaded : Aerosmith
John Doe : Public Announcement Featuring LeLe
Just A Baby Boy : Snoop Dogg Featuring Tyrese & Mr. Tan
Just Another Girl : Monica
Just Friends (Sunny) : Musiq
Kryptonite : 3 Doors Down
La Bomba : Azul Azul
Lady (Hear Me Tonight) : Modjo
Lady Marmalade : Christina Aguilera, Lil' Kim, Mya & Pink
Laredo : Chris Cagle
Lay Low : Snoop Dogg Featuring Master P, Nate Dogg, Butch Cassidy & Tha Eastsidaz
Let Me Blow Ya Mind : Eve Featuring Gwen Stefani
Let's Get Dirty (I Can't Get In Da Club) : Redman Featuring DJ Kool
Let's Get It : Three The... G. Dep, P. Diddy & Black Rob
Liar : Profyle
Lifetime : Maxwell
Lights, Camera, Action! : Mr. Cheeks
Like Wow! : Leslie Carter
Living It Up : Ja Rule Featuring Case
Look At Us : Sarina Paris
Love : Musiq Soulchild
Love Of My Life : Brian McKnight
Loverboy : Mariah Carey Featuring Cameo
Lucky 4 You (Tonight I'm Just Me) : SheDaisy
Mamacita : Public Announcement
Maybe I Deserve : Tank
Meanwhile Back At The Ranch : The Clark Family Experience
Midwest Swing : St. Lunatics
Miss California : Dante Thomas Featuring Pras
Missing You : Case
More Than That : Backstreet Boys
Most Girls : P!nk
Mrs. Steven Rudy : Mark McGuinn
Music : Erick Sermon Featuring Marvin Gaye
My Baby : Lil' Romeo
My Baby You : Marc Anthony
My Everything : 98 Degrees
My First Love : Avant Featuring KeKe Wyatt
My First Love : Avant Featuring Ketara Wyatt
My Projects : Coo Coo Cal
My Way : Limp Bizkit
Never Had A Dream Come True : S Club 7
Never Too Far/Hero (Medley) : Mariah Carey
No More (Baby I'ma Do Right) : 3LW
Nobody Wants To Be Lonely : Ricky Martin With Christina Aguilera
Oh No : Mos Def & Pharoahe Monch Featuring Nate Dogg
Oklahoma : Billy Gilman
One Minute Man : Missy "Misdemeanor" Elliott Featuring Ludacris
One More Day : Diamond Rio
One More Time : Daft Punk
One Step Closer : Linkin Park
One Woman Man : Dave Hollister
Only Time : Enya
Oochie Wally : QB Finest Featuring Nas And Braveheart's
Oochie Wally : QB Finest Featuring Nas And Bravehearts
Oochie Wally : QB's Finest Featuring Nas
Ooohhhwee : Master P Featuring Weebie
Open My Heart : Yolanda Adams
Original Prankster : The Offspring
Outside : Aaron Lewis Of Staind With Fred Durst
Part II : Method Man & Redman
Peaches & Cream : 112
Pinch Me : Barenaked Ladies
Play : Jennifer Lopez
Pour Me : Trick Pony
Project Chick : Cash Money Millionaires
Promise : Jagged Edge
Puppy Love : Lil Bow Wow Featuring Jagged Edge
Purple Hills : D-12
Purple Hills : D12
Put It On Me : Ja Rule Featuring Lil' Mo & Vita
Put It On Me : Ja Rule Featuring Lil' Mo And Vita
Raise Up : Petey Pablo
Request Line : Black Eyed Peas Featuring Macy Gray
Ride Wit Me : Nelly Featuring City Spud
Riding With Private Malone : David Ball
Right Where I Need To Be : Gary Allan
Rock The Boat : Aaliyah
Round & Round : Jonell & Method Man
Sandstorm : Darude
Schism : Tool
Set It Off : Juvenile
She Bangs : Ricky Martin
She Couldn't Change Me : Montgomery Gentry
She Misses Him : Tim Rushlow
She's All I Got : Jimmy Cozier
Shine : Lil' Wayne Featuring Baby, Mack 10 & Mickey
Six-Pack Summer : Phil Vassar
Smooth Criminal : Alien Ant Farm
Snoop Dogg : Snoop Dogg
So Fresh, So Clean : OutKast
So In Love With Two : Mikaila
Son Of A Gun : Janet Featuring Missy Elliott, P. Diddy & Carly Simon
Soul Sista : Bilal
South Side : Moby Featuring Gwen Stefani
Southern Hospitality : Ludacris
Stan : Eminem Featuring Dido
Standing Still : Jewel
Start The Commotion : The Wiseguys
Still On Your Side : BBMak
Stranger In My House : Tamia
Stronger : Britney Spears
Stutter : Joe
Stutter : Joe Featuring Mystikal
Superman (It's Not Easy) : Five For Fighting
Superwoman : Lil' Mo
Superwoman Pt. II : Lil' Mo Featuring Fabolous
Survivor : Destiny's Child
Take Away : Missy "Misdemeanor" Elliott Featuring Ginuwine & Tweet
Take It To Da House : Trick Daddy Featuring The SNS Express
Take You Out : Luther Vandross
Thank You : Dido
Thank You For Loving Me : Bon Jovi
Thank You In Advance : Boyz II Men
That's How I Beat Shaq : Aaron Carter
The Christmas Shoes : NewSong
The Itch : Vitamin C
The Little Girl : John Michael Montgomery
The Rock Show : Blink-182
The Space Between : Dave Matthews Band
The Star Spangled Banner : Whitney Houston
The Whole World : OutKast Featuring Killer Mike
There Is No Arizona : Jamie O'Neal
There It Is : Ginuwine
There She Goes : Babyface
There You'll Be : Faith Hill
This Everyday Love : Rascal Flatts
This I Promise You : 'N Sync
This Is Me : Dream
Two People Fell In Love : Brad Paisley
U Remind Me : Usher
Ugly : Bubba Sparxxx
Until The End Of Time : 2Pac
Video : India.Arie
Wait A Minute : Ray J Featuring Lil' Kim
We Need A Resolution : Aaliyah Featuring Timbaland
We Thuggin' : Fat Joe Featuring R. Kelly
Welcome To Atlanta : Jermaine Dupri & Ludacris
What I Really Meant To Say : Cyndi Thomson
What It Feels Like For A Girl : Madonna
What It Is : Violator Featuring Busta Rhymes
What Would You Do? : City High
What's Going On : All Star Tribute
What's Your Fantasy : Ludacris Featuring Shawna
What's Your Fantasy : Ludacris Featuring Shawnna
When God-Fearin' Women Get The Blues : Martina McBride
When It's Over : Sugar Ray
When Somebody Loves You : Alan Jackson
Whenever, Wherever : Shakira
Where The Party At : Jagged Edge With Nelly
Where The Stars And Stripes And The Eagle Fly : Aaron Tippin
Wherever You Will Go : The Calling
Who I Am : Jessica Andrews
Who We Be : DMX
Who's That Girl? : Eve
Wild Horses : Garth Brooks
With Arms Wide Open : Creed
X : Xzibit
Yellow : Coldplay
You All Dat : Baha Men With Imani Coppola
You Gets No Love : Faith Evans
You Make Me Sick : Pink
You Rock My World : Michael Jackson
You Should've Told Me : Kelly Price
You Shouldn't Kiss Me Like This : Toby Keith
Young'n (Holla Back) : Fabolous
