#1 : Nelly
'03 Bonnie & Clyde : Jay-Z Featuring Beyonce Knowles
19 Somethin' : Mark Wills
7 Days : Craig David
A Little Less Conversation : Elvis Presley vs JXL
A Moment Like This : Kelly Clarkson
A New Day Has Come : Celine Dion
A Thousand Miles : Vanessa Carlton
A Woman's Worth : Alicia Keys
AM To PM : Christina Milian
Addictive : Truth Hurts Featuring Rakim
Ain't It Funny : Jennifer Lopez Featuring Ja Rule
Air Force Ones : Nelly Featuring Kyjuan, Ali & Murphy Lee
Alive : P.O.D.
All Eyez On Me : Monica
All I Have : Jennifer Lopez Featuring LL Cool J
All My Life : Foo Fighters
Always : Saliva
Always On Time : Ja Rule Featuring Ashanti
American Child : Phil Vassar
Any Other Night : Sharissa
Anything : Jaheim Featuring Next
Are We Cuttin' : Pastor Troy Featuring Ms. Jade
Awnaw : Nappy Roots
Be Here : Raphael Saadiq Featuring D'Angelo
Beautiful : Christina Aguilera
Beautiful Mess : Diamond Rio
Big Machine : Goo Goo Dolls
Black Suits Comin' (Nod Ya Head) : Will Smith Featuring Tra-Knox
Blessed : Martina McBride
Blue Jeans : Yasmeen Featuing Ghostface Killah
Blue Jeans : Yasmeen Featuring Ghostface Killah
Blurry : Puddle Of Mudd
Bother : Stone Sour
Bouncin' Back (Bumpin' Me Against The Wall) : Mystikal
Break Ya Neck : Busta Rhymes
Breathe : Telepopmusik
Bring On The Rain : Jo Dee Messina With Tim McGraw
Brotha : Angie Stone
Bump, Bump, Bump : B2K & P. Diddy
Burn : Mobb Deep Featuring Vita & Noyd
Burnin' Up : Faith Evans Featuring Missy "Misdemeanor" Elliott
Butterflies : Michael Jackson
By The Way : Red Hot Chili Peppers
Can't Fight The Moonlight : LeAnn Rimes
Can't Get You Out Of My Head : Kylie Minogue
Caramel : City High Featuring Eve
Chop Suey : System Of A Down
Cleanin' Out My Closet : Eminem
Closet Freak : Cee-Lo
Cochise : Audioslave
Come Close To Me : Common Featuring Mary J. Blige
Complicated : Avril Lavigne
Crush Tonight : Fat Joe Featuring Ginuwine
Cry : Faith Hill
Dance With Me : 112
Day + Night : Isyss Featuring Jadakiss
Days Go By : Dirty Vegas
Defy You : The Offspring
Die Another Day : Madonna
Differences : Ginuwine
Dig In : Lenny Kravitz
Dilemma : Nelly Featuring Kelly Rowland
Dirrty : Christina Aguilera Featuring Redman
Disease : matchbox twenty
Do That... : Baby Featuring P. Diddy
Do U Wanna Roll (Dolittle Theme) : R.L., Snoop Dogg & Lil' Kim
Don't Know Why : Norah Jones
Don't Mess With My Man : Nivea Featuring Brian & Brandon Casey
Don't Say No, Just Say Yes : Avant
Don't You Forget It : Glenn Lewis
Dontchange : Musiq
Down 4 U : Irv Gotti Presents The Inc. Featuring Ja Rule, Ashanti, Charli Baltimore & Vita
Down A** Chick : Ja Rule Featuring Charli "Chuck" Baltimore
Downfall : TRUSTcompany
Drops Of Jupiter (Tell Me) : Train
Drowning : Backstreet Boys
Emotion : Destiny's Child
Everywhere : Michelle Branch
Fabulous : Jaheim Featuring Tha Rayne
Fall Into Me : Emerson Drive
Family Affair : Mary J. Blige
Fatty Girl : Ludacris, LL Cool J & Keith Murray
Feel It Boy : Beenie Man Featuring Janet
Feel The Girl : Ms. Jade
Feels Good (Don't Worry Bout A Thing) : Naughty By Nature Featuring 3LW
Fine Again : Seether
Flake : Jack Johnson
For All Time : Soluna
Forgive : Rebecca Lynn Howard
From Her Mama (Mama Got A**) : Juvenile
From Tha Chuuuch To Da Palace : Snoop Dogg
Gangsta Lovin' : Eve Featuring Alicia Keys
Get The Party Started : Pink
Gimme The Light : Sean Paul
Girl Talk : TLC
Girlfriend : 'N Sync Featuring Nelly
Give It To Her : Tanto Metro & Devonte
God Bless America : Daniel Rodriguez
God Bless The USA : Lee Greenwood
Gone : 'N Sync
Good Morning Beautiful : Steve Holy
Good Times : Styles
Goodbye : Jagged Edge
Gossip Folks : Missy "Misdemeanor" Elliott Featuring Ludacris
Got Ur Self A... : Nas
Gotta Get Thru This : Daniel Bedingfield
Grindin' : The Clipse
Guess Who's Back : Scarface Featuring Jay-Z & Beanie Sigel
Hands Clean : Alanis Morissette
Hanging By A Moment : Lifehouse
Happy : Ashanti
Hate To Say I Told You So : The Hives
He Is : Heather Headley
Heaven : DJ Sammy & Yanou Featuring Do
Hella Good : No Doubt
Here Is Gone : The Goo Goo Dolls
Here To Stay : Korn
Hero : Chad Kroeger Featuring Josey Scott
Hero : Enrique Iglesias
Hey Baby : No Doubt Featuring Bounty Killer
Hey Luv (Anything) : Mobb Deep Featuring 112
Hey Ma : Cam'ron Featuring Juelz Santana, Freekey Zekey & Toya
Hit The Freeway : Toni Braxton Featuring Loon
How You Remind Me : Nickelback
Hush Lil' Lady : Corey Featuring Lil' Romeo
I Am Mine : Pearl Jam
I Breathe In, I Breathe Out : Chris Cagle
I Do (Wanna Get Close To You) : 3LW Featuring P. Diddy & Loon
I Do!! : Toya
I Don't Have To Be Me ('Til Monday) : Steve Azar
I Don't Want You To Go : Carolyn Dawn Johnson
I Just Wanna Be Mad : Terri Clark
I Keep Looking : Sara Evans
I Love You : Faith Evans
I Miss My Friend : Darryl Worley
I Miss You : DMX Featuring Faith Evans
I Need A Girl (Part One) : P. Diddy Featuring Usher & Loon
I Need A Girl (Part Two) : P. Diddy & Ginuwine Featuring Loon, Mario Winans & Tammy Ruggeri
I Need A Girl (Part Two) : P. Diddy & Ginuwine Featuring Loon, Mario Winans & Tammy Ruggieri
I Should Be... : Dru Hill
I Told Y'all : Petey Pablo
I Wanna Talk About Me : Toby Keith
I'd Rather : Luther Vandross
I'm A Slave 4 U : Britney Spears
I'm A Survivor : Reba
I'm Gonna Be Alright : Jennifer Lopez Featuring Nas
I'm Gonna Getcha Good! : Shania Twain
I'm Movin' On : Rascal Flatts
I'm Tryin' : Trace Adkins
I've Got You : Marc Anthony
If I Could Go! : Angie Martinez Featuring Lil' Mo & Sacario
In A Little While : Uncle Kracker
In Another World : Joe Diffie
In Da Wind : Trick Daddy Featuring Cee-Lo & Big Boi
In The End : Linkin Park
Insatiable : Darren Hayes
It's Been Awhile : Staind
It's Goin' Down : X-Ecutioners
Jenny From The Block : Jennifer Lopez Featuring Jadakiss & Styles
Jigga : Jay-Z
Just A Friend 2002 : Mario
Just Let Me Be In Love : Tracy Byrd
Knoc : Knoc-Turn'Al With Dr. Dre & Missy "Misdemeanor" Elliott
Let's Stay Home Tonight : Joe
Lifestyles Of The Rich And Famous : Good Charlotte
Lifetime : Maxwell
Lights, Camera, Action! : Mr. Cheeks
Like I Love You : Justin Timberlake
Little Things : India.Arie
Livin' It Up : Ja Rule Featuring Case
Love Of A Woman : Travis Tritt
Love Of My Life (An Ode To Hip Hop) : Erykah Badu Featuring Common
Love Of My Life : Brian McKnight
Luv U Better : LL Cool J
Luv U Better : LL Cool J Featuring Marc Dorsey
Make It Clap : Busta Rhymes Featuring Spliff Star
Move B***h : Ludacris Featuring Mystikal & Infamous 2.0
My Friends Over You : New Found Glory
My Neck, My Back : Khia Featuring DSD
My Sacrifice : Creed
My Sweet Lord : George Harrison
My Town : Montgomery Gentry
Never : Amanda Perez
Never Too Far/Hero Medley : Mariah Carey
No One Knows : Queens Of The Stone Age
No Such Thing : John Mayer
Nothin' : N.O.R.E.
Nothing In This World : Keke Wyatt Featuring Avant
Oh Boy : Cam'ron Featuring Juelz Santana
Oh Yeah! : Big Tymers Featuring Tateeze, Boo & Gotti
Only Time : Enya
Ooohhhwee : Master P Featuring Weebie
Oops (Oh My) : Tweet
Out Of My Heart (Into Your Head) : BBMak
Papa Don't Preach : Kelly Osbourne
Paradise : LL Cool J Featuring Amerie
Part II : Method Man & Redman
Pass The Courvoisier Part II : Busta Rhymes Featuring P. Diddy & Pharrell
Picture : Kid Rock Featuring Sheryl Crow
Po' Folks : Nappy Roots Featuring Anthony Hamilton
Prayer : Disturbed
Quitame Ese Hombre : Pilar Montenegro
Rainy Dayz : Mary J. Blige Featuring Ja Rule
Rapture (Tastes So Sweet) : iio
React : Erick Sermon Featuring Redman
Riding With Private Malone : David Ball
Roc The Mic : Beanie Sigel & Freeway
Rock The Boat : Aaliyah
Rock The Party : Benzino
Roll Out (My Business) : Ludacris
Round And Round : Jonell & Method Man
Run : George Strait
Runaway : NB Ridaz Featuring Angelina
Running Away : Hoobastank
Satisfaction : Eve
Saturday (Oooh! Ooooh!) : Ludacris Featuring Sleepy Brown
Say I Yi Yi : Ying Yang Twins
She Loves Me Not : Papa Roach
She Was : Mark Chesnutt
Sick Of Being Lonely : Field Mob
Single For The Rest Of My Life : Isyss
Smooth Criminal : Alien Ant Farm
Soak Up The Sun : Sheryl Crow
Some Days You Gotta Dance : Dixie Chicks
Somebody Like You : Keith Urban
Someone To Love You : Ruff Endz
Something : Lasgo
Somewhere Out There : Our Lady Peace
Son Of A Gun : Janet Featuring Missy Elliott, P. Diddy & Carly Simon
Song For The Lonely : Cher
Standing Still : Jewel
Starry Eyed Surprise : Oakenfold Featuring Shifty Shellshock
Still Fly : Big Tymers
Stole : Kelly Rowland
Stuck In A Moment You Can't Get Out Of : U2
Sugarhigh : Jade Anderson
Superman (It's Not Easy) : Five For Fighting
Tainted : Slum Village Featuring Dwele
Take A Message : Remy Shand
Take Away : Missy "Misdemeanor" Elliott Featuring Ginuwine & Tweet
Take Ya Home : Lil Bow Wow
Take You Home With Me a.k.a. Body : R. Kelly & Jay-Z
Tell Me What's It Gonna Be : Brian McKnight Featuring Jermaine Dupri
Thank You : Lil Bow Wow Featuring Jagged Edge & Fundisha
That's Just Jessie : Kevin Denney
The Baby : Blake Shelton
The Cowboy In Me : Tim McGraw
The Game Of Love : Santana Featuring Michelle Branch
The Impossible : Joe Nichols
The Ketchup Song (Hey Hah) : Las Ketchup
The Long Goodbye : Brooks & Dunn
The Middle : Jimmy Eat World
The One : Gary Allan
The One You Love : Paulina Rubio
The Red : Chevelle
The Rising : Bruce Springsteen
The Star Spangled Banner : Whitney Houston
The Streets : WC Featuring Nate Dogg
The Whole World : OutKast Featuring Killer Mike
The World's Greatest : R. Kelly
These Are The Days : O-Town
Thug Holiday : Trick Daddy Featuring LaTocha Scott
Thug Lovin' : Ja Rule Featuring Bobby Brown
Thugz Mansion : 2Pac
Tonight I Wanna Be Your Man : Andy Griggs
Trade It All : Fabolous Featuring P. Diddy & Jagged Edge
Turn Off The Light : Nelly Furtado
Two Wrongs : Wyclef Jean Featuring Claudette Ortiz
U Got It Bad : Usher
Ugly : Bubba Sparxxx
Uh Huh : B2K
Underneath It All : No Doubt Featuring Lady Saw
Wanksta : 50 Cent
Wasting My Time : Default
Way Of Life : Lil Wayne
We Thuggin' : Fat Joe Featuring R. Kelly
Welcome To Atlanta : Jermaine Dupri & Ludacris
What About Us? : Brandy
What Am I Gonna Do : Tyrese
What If She's An Angel : Tommy Shane Steiner
What's Luv? : Fat Joe Featuring Ashanti
When I'm Gone : 3 Doors Down
When The Last Time : Clipse
When You Lie Next To Me : Kellie Coffey
Whenever, Wherever : Shakira
Where Are You Going : Dave Matthews Band
Where Do We Go From Here : Filter
Where The Stars And Stripes And The Eagle Fly : Aaron Tippin
Where Were You (When The World Stopped Turning) : Alan Jackson
Wherever You Will Go : The Calling
Whoa Now : B Rich
Why Don't We Fall In Love : Amerie
Wish You Were Here : Incubus
With Me : Lonestar
Work It : Missy "Misdemeanor" Elliott
Wrapped Around : Brad Paisley
Wrapped Up In You : Garth Brooks
Wrong Impression : Natalie Imbruglia
You Can't Hide Beautiful : Aaron Lines
You Know That I Love You : Donell Jones
You Know You're Right : Nirvana
Young : Kenny Chesney
Young'n (Holla Back) : Fabolous
