'03 Bonnie & Clyde : Jay-Z Featuring Beyonce Knowles
(I Hate) Everything About You : Three Days Grace
(There's Gotta Be) More To Life : Stacie Orrico
19 Somethin' : Mark Wills
21 Questions : 50 Cent Featuring Nate Dogg
24's : T.I.
4 Ever : Lil' Mo Featuring Fabolous
99.9% Sure (I've Never Been Here Before) : Brian McComas
A Few Questions : Clay Walker
A.D.I.D.A.S. : Killer Mike Featuring Big Boi
Act A Fool : Ludacris
Addicted : Simple Plan
Air Force Ones : Nelly Featuring Kyjuan, Ali & Murphy Lee
All I Have : Jennifer Lopez Featuring LL Cool J
All I Need : Fat Joe Featuring Tony Sunshine & Armageddon
All The Things She Said : t.A.T.u.
Almost Home : Craig Morgan
Always : Saliva
Amazing : Josh Kelley
American Life : Madonna
Angel : Amanda Perez
Another Postcard (Chimps) : Barenaked Ladies
Are You Gonna Be My Girl : Jet
Are You Happy Now? : Michelle Branch
Away From Me : Puddle Of Mudd
B R Right : Trina Featuring Ludacris
Baby Boy : Beyonce Featuring Sean Paul
Bad Boy This Bad Boy That : Bad Boy's Da Band
Badaboom : B2K Featuring Fabolous
Beautiful : Snoop Dogg Featuring Pharrell & Uncle Charlie Wilson
Beautiful Goodbye : Jennifer Hanson
Beer For My Horses : Toby Keith Duet With Willie Nelson
Beware Of The Boys (Mundian To Bach Ke) : Panjabi MC Featuring Jay-Z
Big Yellow Taxi : Counting Crows Featuring Vanessa Carlton
Bigger Than My Body : John Mayer
Blowin' Me Up (With Her Love) : JC Chasez
Bother : Stone Sour
Break You Off : The Roots Featuring Musiq
Breathe : Blu Cantrell
Breathe : Blu Cantrell Featuring Sean Paul
Breathe : Telepopmusik
Bring Me To Life : Evanescence Featuring Paul McCoy
Brokenheartsville : Joe Nichols
Bump, Bump, Bump : B2K & P. Diddy
Calling All Angels : Train
Can't Hold Us Down : Christina Aguilera Featuring Lil' Kim
Can't Let You Go : Fabolous Featuring Mike Shorey & Lil' Mo
Can't Nobody : Kelly Rowland
Can't Stop : Red Hot Chili Peppers
Can't Stop Loving You : Phil Collins
Can't Stop, Won't Stop : Young Gunz
Celebrity : Brad Paisley
Choppa Style : Choppa Featuring Master P
Clap Back : Ja Rule
Clocks : Coldplay
Clubbin : Marques Houston Featuring Joe Budden & Pied Piper
Come Close To Me : Common Featuring Mary J. Blige
Come Close To Me : Common Featuring Mary J. Blige Or Erykah Badu, Pharrell & Q-Tip
Come Into My World : Kylie Minogue
Come Over : Aaliyah
Cop That Sh#! : Timbaland & Magoo Featuring Missy Elliott
Cowboys Like Us : George Strait
Crazy : Javier
Crazy In Love : Beyonce Featuring Jay-Z
Cry : Faith Hill
Damaged : TLC
Damn! : YoungBloodZ Featuring Lil Jon
Dance With My Father : Luther Vandross
Danger : Erykah Badu
Did My Time : Korn
Dilemma : Nelly Featuring Kelly Rowland
Dirrty : Christina Aguilera Featuring Redman
Do That... : Baby Featuring P. Diddy
Don't Dream It's Over : Sixpence None The Richer
Don't Know Why : Norah Jones
Don't Mess With My Man : Nivea Featuring Brian & Brandon Casey
Don't Wanna Try : Frankie J
Don't Wanna Try : Frankie J.
Drift Away : Uncle Kracker Featuring Dobie Gray
Emotional Rollercoaster : Vivian Green
Excuse Me Miss : Jay-Z
F**k It (I Don't Want You Back) : Eamon
Fabulous : Jaheim Featuring Tha Rayne
Faint : Linkin Park
Fall Into Me : Emerson Drive
Fallen : Sarah McLachlan
Feel Good Time : Pink Featuring William Orbit
Feelin' Freaky : Nick Cannon Featuring B2K
Fighter : Christina Aguilera
Find A Way : Dwele
Fine Again : Seether
Flipside : Freeway Featuring Peedi Crakk
Flying Without Wings : Ruben Studdard
Forever And For Always : Shania Twain
Forthenight : Musiq
From Tha Chuuuch To Da Palace : Snoop Dogg
Frontin' : Pharrell Featuring Jay-Z
Gangsta Girl : Big Tymers Featuring R. Kelly
Gangsta Nation : Westside Connection Featuring Nate Dogg
Get By : Talib Kweli
Get Low : Lil Jon & The East Side Boyz Featuring Ying Yang Twins
Gigolo : Nick Cannon Featuring R. Kelly
Girl All The Bad Guys Want : Bowling For Soup
Girlfriend : B2K
Girls And Boys : Good Charlotte
God Bless The U.S.A. : American Idol Finalists
Gossip Folks : Missy "Misdemeanor" Elliott Featuring Ludacris
Got Some Teeth : Obie Trice
Harder To Breathe : Maroon5
Have You Forgotten? : Darryl Worley
Headstrong : Trapt
Heaven : Live
Hell Yeah : Ginuwine Featuring Baby
Help Pour Out The Rain (Lacey's Song) : Buddy Jewell
Here Without You : 3 Doors Down
Hey Ma : Cam'ron Featuring Juelz Santana, Freekey Zekey & Toya
Hey Ya! : OutKast
Hit That : The Offspring
Hit The Freeway : Toni Braxton Featuring Loon
Hole In The World : Eagles
Holidae In : Chingy Featuring Ludacris & Snoop Dogg
Honesty (Write Me A List) : Rodney Atkins
Hot & Wet : 112 Featuring Ludacris
Hotel : Cassidy Featuring R. Kelly
How You Want That : Loon Featuring Kelis
I Believe : Diamond Rio
I Can : Nas
I Can Only Imagine : MercyMe
I Can't Take You Anywhere : Scotty Emerick With Toby Keith
I Drove All Night : Celine Dion
I Just Wanna Be Mad : Terri Clark
I Know What You Want : Busta Rhymes & Mariah Carey Featuring The Flipmode Squad
I Love This Bar : Toby Keith
I Love You : Dru Hill
I Melt : Rascal Flatts
I Need You Now : Smokie Norful
I Want You : Thalia Featuring Fat Joe
I Wish I Wasn't : Heather Headley
I'm Glad : Jennifer Lopez
I'm With You : Avril Lavigne
If You're Not The One : Daniel Bedingfield
In A Little While : Uncle Kracker
In Love Wit Chu : Da Brat Featuring Cherish
In Those Jeans : Ginuwine
Into You : Fabolous Featuring Tamia Or Ashanti
Intuition : Jewel
It's Five O'Clock Somewhere : Alan Jackson & Jimmy Buffett
It's My Life : No Doubt
Jenny From The Block : Jennifer Lopez Featuring Jadakiss & Styles
Jenny From The Block : Jennifer Lopez Featuring Styles & Jadakiss
Just Because : Jane's Addiction
Landslide : Dixie Chicks
Laundromat : Nivea
Let's Get Down : Bow Wow Featuring Baby
Light Your A** On Fire : Busta Rhymes
Like A Pimp : David Banner Featuring Lil' Flip
Like Glue : Sean Paul
Long Black Train : Josh Turner
Love At 1st Sight : Mary J. Blige Featuring Method Man
Love Of My Life (An Ode To Hip Hop) : Erykah Badu Featuring Common
Lovin' All Night : Patty Loveless
Luv U Better : LL Cool J
Ma, I Don't Love Her : Clipse Featuring Faith Evans
Magic Stick : Lil' Kim Featuring 50 Cent
Make It Clap : Busta Rhymes Featuring Spliff Star
Make Me A Song : Kiley Dean
Me Against The Music : Britney Spears Featuring Madonna
Me, Myself And I : Beyonce
Mesmerize : Ja Rule Featuring Ashanti
Milkshake : Kelis
Miss Independent : Kelly Clarkson
More & More : Joe
My Baby : Bow Wow Featuring Jagged Edge
My Front Porch Looking In : Lonestar
My Love Is Like... Wo : Mya
Na Na Na Na : 112 Featuring Super Cat
Naggin : Ying Yang Twins
Neva Eva : Trillville
Never (Past Tense) : The Roc Project Featuring Tina Arena
Never Leave You - Uh Ooh, Uh Oooh! : Lumidee
Never Scared : Bone Crusher Featuring Killer Mike & T.I.
Never Scared : Bonecrusher Featuring Killer Mike & T.I.
No Letting Go : Wayne Wonder
No One Knows : Queens Of The Stone Age
No One's Gonna Change You : Reina
No Shoes, No Shirt, No Problems : Kenny Chesney
Not Today : Mary J. Blige Featuring Eve
Officially Missing You : Tamia
One Last Breath : Creed
One More Chance : Michael Jackson
Ooh! : Mary J. Blige
P***ycat : Missy "Misdemeanor" Elliott
P.I.M.P. : 50 Cent
Paradise : LL Cool J Featuring Amerie
Party To Damascus : Wyclef Jean Featuring Missy Elliott
Pass That Dutch : Missy Elliott
Peacekeeper : Fleetwood Mac
Picture : Kid Rock Featuring Sheryl Crow
Picture : Kid Rock Featuring Sheryl Crow Or Allison Moorer
Pimp Juice : Nelly
Pon De River, Pon De Bank : Elephant Man
Pop That Booty : Marques Houston Featuring Jermaine "JD" Dupri
Prayer : Disturbed
Pump It Up : Joe Budden
Put That Woman First : Jaheim
React : Erick Sermon Featuring Redman
Read Your Mind : Avant
Real Good Man : Tim McGraw
Red Dirt Road : Brooks & Dunn
Right Thurr : Chingy
Roc Ya Body "Mic Check 1,2" : M.V.P. (Most Valuable Playas) Featuring Stagga Lee
Rock The Party : Benzino
Rock Wit U (Awww Baby) : Ashanti
Roll Wit M.V.P. : Stagga Lee
Roun' The Globe : Nappy Roots
Rubberneckin' : Elvis Presley
Runnin (Dying To Live) : Tupac Featuring The Notorious B.I.G.
Salt Shaker : Ying Yang Twins Featuring Lil Jon & The East Side Boyz
Satisfaction : Eve
Say Yes : Floetry
Send The Pain Below : Chevelle
Senorita : Justin Timberlake
Seven Nation Army : The White Stripes
Shake That Monkey : Too Short Featuring Lil Jon & The East Side Boyz
Shake Ya Tailfeather : Nelly, P. Diddy & Murphy Lee
Show Me How To Live : Audioslave
Sick Of Being Lonely : Field Mob
Signs Of Love Makin' : Tyrese
Simply Being Loved (Somnambulist) : BT
Sing For The Moment : Eminem
Single For The Rest Of My Life : Isyss
Slow Jamz : Twista Featuring Kanye West & Jamie Foxx
Snake : R. Kelly Featuring Big Tigger
So Far Away : Staind
So Gone : Monica
So Yesterday : Hilary Duff
Someday : Nickelback
Something : Lasgo
Somewhere Out There : Our Lady Peace
Speed : Montgomery Gentry
Spin : Lifehouse
Stacy's Mom : Fountains Of Wayne
Stand Up : Ludacris Featuring Shawnna
Stay Gone : Jimmy Wayne
Step Daddy : Hitman Sammy Sam
Still Ballin : 2Pac Featuring Trick Daddy
Straight Out Of Line : Godsmack
Stunt 101 : G-Unit
Stupid Girl : Cold
Suga Suga : Baby Bash Featuring Frankie J
Swing, Swing : The All-American Rejects
Sympathy For The Devil : The Rolling Stones
Take Me Away : Fefe Dobson
Take You Home : Angie Martinez Featuring Kelis
Tal Vez : Ricky Martin
Talkin' To Me : Amerie
Tell Me (What's Goin' On) : Smilez & Southstar
That Girl : Marques Houston
That'd Be Alright : Alan Jackson
The Baby : Blake Shelton
The Boys Of Summer : The Ataris
The First Cut Is The Deepest : Sheryl Crow
The Game Of Love : Santana Featuring Michelle Branch
The Jump Off : Lil' Kim Featuring Mr. Cheeks
The Love Song : Jeff Bates
The Remedy (I Won't Worry) : Jason Mraz
The Truth About Men : Tracy Byrd
The Way You Move : OutKast Featuring Sleepy Brown
The Wreckoning : Boomkat
Then They Do : Trace Adkins
These Are The Days : O-Town
This Is How We Do : Big Tymers
This Is The Night : Clay Aiken
This One's For The Girls : Martina McBride
Thoia Thoing : R. Kelly
Three Wooden Crosses : Randy Travis
Through The Rain : Mariah Carey
Through The Wire : Kanye West
Thug Holiday : Trick Daddy Featuring LaTocha Scott
Thug Lovin' : Ja Rule Featuring Bobby Brown
Thugz Mansion : 2Pac
Times Like These : Foo Fighters
Tough Little Boys : Gary Allan
Trouble : Pink
Try It On My Own : Whitney Houston
Underneath It All : No Doubt Featuring Lady Saw
Unwell : matchbox twenty
Waiting For You : Seal
Walk A Little Straighter : Billy Currington
Walked Outta Heaven : Jagged Edge
Wat Da Hook Gon Be : Murphy Lee Featuring Jermaine Dupri
Wave On Wave : Pat Green
Weak And Powerless : A Perfect Circle
What A Beautiful Day : Chris Cagle
What Happened To That Boy : Baby Featuring Clipse
What The World Needs : Wynonna
What Was I Thinkin' : Dierks Bentley
What We Do : Freeway Featuring Jay-Z & Beanie Sigel
What Would You Do? : The Isley Brothers Featuring Ronald Isley
When The Last Time : Clipse
Where Is The Love? : Black Eyed Peas
Where The Hood At? : DMX
White Flag : Dido
Who Wouldn't Wanna Be Me : Keith Urban
Why Can't I : Liz Phair
Why Don't You & I : Santana Featuring Alex Band Or Chad Kroeger
With You : Jessica Simpson
Yeah Yeah U Know It : Keith Murray Featuring Def Squad
You : Ryan Duarte
You Can't Hide Beautiful : Aaron Lines
You Don't Know My Name : Alicia Keys
You Know You're Right : Nirvana
