(Reach Up For The) Sunrise : Duran Duran
(There's Gotta Be) More To Life : Stacie Orrico
1, 2 Step : Ciara Featuring Missy Elliott
100 Years : Five For Fighting
1985 : Bowling For Soup
8th World Wonder : Kimberley Locke
Accidentally In Love : Counting Crows
All Falls Down : Kanye West Featuring Syleena Johnson
Alone : Lasgo
American Idiot : Green Day
Another Postcard (Chimps) : Barenaked Ladies
Away From Me : Puddle Of Mudd
Awful, Beautiful Life : Darryl Worley
Baby Boy : Beyonce Featuring Sean Paul
Baby Girl : Sugarland
Baby I Love U : Jennifer Lopez
Baby It's You : JoJo Featuring Bow Wow
Badaboom : B2K Featuring Fabolous
Balla Baby : Chingy
Beautiful Soul : Jesse McCartney
Behind Blue Eyes : Limp Bizkit
Big Chips : R. Kelly & Jay-Z
Bounce : Sarah Connor
Break Down Here : Julie Roberts
Breakaway : Kelly Clarkson
Breathe : Fabolous
Breathe : Michelle Branch
Breathe, Stretch, Shake : Mase Featuring P. Diddy
Bridging The Gap : Nas Featuring Olu Dara
Broken : Seether Featuring Amy Lee
Burn : Usher
Call My Name : Prince
Car Wash : Christina Aguilera Featuring Missy Elliott
Ch-Check It Out : Beastie Boys
Charlene : Anthony Hamilton
Chicks Dig It : Chris Cagle
Clubbin : Marques Houston Featuring Joe Budden & Pied Piper
Cold : Crossfade
Cold Hard Bitch : Jet
Come Clean : Hilary Duff
Coo-Coo Chee : Ric-A-Che
Culo : Pitbull Featuring Lil Jon
Damn! : YoungBloodZ Featuring Lil Jon
Daughters : John Mayer
Desperately : George Strait
Diary : Alicia Keys Featuring Tony! Toni! Tone!
Dip It Low : Christina Milian
Dirt Off Your Shoulder : Jay-Z
Disco Inferno : 50 Cent
Don't Take Your Love Away : Avant
Don't Tell Me : Avril Lavigne
Dreams : Diana DeGarmo
Drinkin' Bone : Tracy Byrd
Drop It Like It's Hot : Snoop Dogg Featuring Pharrell
Dude : Beenie Man Featuring Ms. Thing
Encore : Eminem Featuring Dr. Dre & 50 Cent
Everything : Alanis Morissette
Everytime : Britney Spears
F**k It (I Don't Want You Back) : Eamon
F.U.R.B. (F U Right Back) : Frankee
Fallen : Mya
Fallen : Sarah McLachlan
Falls On Me : Fuel
Float On : Modest Mouse
Freaks : Play-N-Skillz Featuring Krayzie Bone & Adina Howard
Freek-A-Leek : Petey Pablo
Gal Yuh Ah Lead : T.O.K.
Game Over (Flip) : Lil' Flip
Gangsta Girl : Big Tymers Featuring R. Kelly
Gangsta Nation : Westside Connection Featuring Nate Dogg
Gasolina : Daddy Yankee
Get Low : Lil Jon & The East Side Boyz Featuring Ying Yang Twins
Get No Better : Cassidy Featuring Mashonda
Getting Away With Murder : Papa Roach
Gigolo : Nick Cannon Featuring R. Kelly
Girls Lie Too : Terri Clark
Give A Little Bit : Goo Goo Dolls
Go D.J. : Lil Wayne
Good Little Girls : Blue County
Goodies : Ciara Featuring Petey Pablo
Got It Twisted : Mobb Deep
Gotta Go Solo : Patti LaBelle Featuring Ron Isley
Happy People : R. Kelly
Headsprung : LL Cool J
Headstrong : Trapt
Heaven : Live
Heaven : Los Lonely Boys
Here Without You : 3 Doors Down
Hey Good Lookin' : Jimmy Buffett With Clint Black, Kenny Chesney, Alan Jackson, Toby Keith & George Strait
Hey Mama : Black Eyed Peas
Hey Now (Mean Muggin) : Xzibit Featuring Keri Hilson
Hit That : The Offspring
Hold On : Good Charlotte
Hole In The Head : Sugababes
Holidae In : Chingy Featuring Ludacris & Snoop Dogg
Honesty (Write Me A List) : Rodney Atkins
Hot 2Nite : New Edition
Hot Mama : Trace Adkins
Hotel : Cassidy Featuring R. Kelly
How Am I Doin' : Dierks Bentley
How Come : D12
How Did You Know? : Mynt Featuring Kim Sozzi
How Far : Martina McBride
Hush : LL Cool J Featuring 7 Aurelius
I Am The Highway : Audioslave
I Believe : Fantasia
I Can Only Imagine : MercyMe
I Can't Sleep : Clay Walker
I Can't Wait : Sleepy Brown Featuring OutKast
I Changed My Mind : Keyshia Cole Featuring Shyne
I Don't Wanna Know : Mario Winans Featuring Enya & P. Diddy
I Don't Wanna Know : Mario Winans Featuring P. Diddy & Enya
I Don't Want To Be : Gavin DeGraw
I Go Back : Kenny Chesney
I Got A Feelin' : Billy Currington
I Like That : Houston Featuring Chingy, Nate Dogg & I-20
I Love You This Much : Jimmy Wayne
I Miss You : Blink-182
I Smoke, I Drank : Body Head Bangerz Featuring YoungBloodz
I Want To Live : Josh Gracin
I Want You : Janet Jackson
I Wish : Jo Dee Messina
I'm Ready : Cherie
I'm Really Hot : Missy Elliott
I'm Still In Love With You : Sean Paul Featuring Sasha
If I Ain't Got You : Alicia Keys
If Nobody Believed In You : Joe Nichols
If You Ever Stop Loving Me : Montgomery Gentry
In A Real Love : Phil Vassar
In My Life : Juvenile Featuring Mannie Fresh
It's My Life : No Doubt
Jesus Walks : Kanye West
Jook Gal (Wine Wine) : Elephant Man
Just For You : Lionel Richie
Just Like You : Three Days Grace
Just Lose It : Eminem
Karma : Lloyd Banks Featuring Avant
King Of The Dancehall : Beenie Man
Knuck If You Buck : Crime Mob Featuring Lil Scrappy
Last One Standing : Emerson Drive
Last Train Home : Lostprophets
Lean Back : Terror Squad
Leave (Get Out) : JoJo
Let Me Love You : Mario
Let's Be Us Again : Lonestar
Let's Get Away : T.I.
Let's Go (2004) : Trick Daddy
Let's Go : Trick Daddy Featuring Lil Jon & Twista
Letters From Home : John Michael Montgomery
Little Moments : Brad Paisley
Live Like You Were Dying : Tim McGraw
Locked Up : Akon Featuring Styles P.
Loco : David Lee Murphy
Long Black Train : Josh Turner
Lose My Breath : Destiny's Child
Love Me Right (Oh Sheila) : Angel City Featuring Lara McAllen
Love Song : 311
Love You More : Ginuwine
Love's Divine : Seal
Lovers And Friends : Lil Jon & The East Side Boyz Featuring Usher & Ludacris
Lying From You : Linkin Park
Maps : Yeah Yeah Yeahs
Mayberry : Rascal Flatts
Me Against The Music : Britney Spears Featuring Madonna
Meant To Live : Switchfoot
Megalomaniac : Incubus
Milkshake : Kelis
More & More : Joe
Move Ya Body : Nina Sky Featuring Jabba
My Baby : Bow Wow Featuring Jagged Edge
My Band : D12 Featuring Eminem
My Boo : Usher & Alicia Keys
My Boo : Usher And Alicia Keys
My Immortal : Evanescence
My Place : Nelly Featuring Jaheim
Nasty Girl : Nitty
Naughty Girl : Beyonce
Neva Eva : Trillville
New Day : Patti LaBelle
New York : Ja Rule Featuring Fat Joe & Jadakiss
No Better Love : Young Gunz Featuring Rell
No Problem : Lil Scrappy
Nolia Clap : Juvenile, Wacko & Skip
Not Today : Mary J. Blige Featuring Eve
Nothin 'Bout Love Makes Sense : LeAnn Rimes
Numb/Encore : Jay-Z/Linkin Park
Ocean Avenue : Yellowcard
Okay : Nivea Featuring Lil Jon & YoungBloodZ
On Fire : Lloyd Banks
On The Way Down : Ryan Cabrera
One Call Away : Chingy Featuring J. Weav
One Day At A Time : Tupac With Eminem Featuring The Outlawz
One More Chance : Michael Jackson
One Thing : Finger Eleven
Only U : Ashanti
Over And Over : Nelly Featuring Tim McGraw
Overnight Celebrity : Twista
Oye Mi Canto : N.O.R.E. Featuring Daddy Yankee, Nina Sky, Gem Star & Big Mato
Oye Mi Canto : N.O.R.E., GemStar, Big Mato, Nina Sky & Daddy Yankee
Oye Mi Canto : N.O.R.E., GemStar, Big Mato, Nina Sky & Tego Calderon
Paint Me A Birmingham : Tracy Lawrence
Party For Two : Shania Twain With Billy Currington Or Mark McGrath
Passenger Seat : SheDaisy
Perdidos : Monchy & Alexandra
Perfect : Sara Evans
Pieces Of Me : Ashlee Simpson
Pop That Booty : Marques Houston Featuring Jermaine "JD" Dupri
Pull Up : Mr. Vegas
Real Big : Mannie Fresh
Redneck Woman : Gretchen Wilson
Remember When : Alan Jackson
Rich Girl : Gwen Stefani Featuring Eve
Ride Wit U : Joe Featuring G-Unit
Roses : OutKast
Runnin (Dying To Live) : Tupac Featuring The Notorious B.I.G.
Salt Shaker : Ying Yang Twins Featuring Lil Jon & The East Side Boyz
Scandalous : Mis-Teeq
Selfish : Slum Village Featuring Kanye West & John Legend
Shake That Monkey : Too Short Featuring Lil Jon & The East Side Boyz
Shake That Sh** : Shawnna Featuring Ludacris
Shake Ya Tailfeather : Nelly, P. Diddy & Murphy Lee
She Thinks She Needs Me : Andy Griggs
She's Not Just A Pretty Face : Shania Twain
Shorty Wanna Ride : Young Buck
Simple Life : Carolyn Dawn Johnson
Slither : Velvet Revolver
Slow : Kylie Minogue
Slow Jamz : Twista Featuring Kanye West & Jamie Foxx
Slow Motion : Juvenile Featuring Soulja Slim
So Cold : Breaking Benjamin
So Far Away : Staind
So Fly : NB Ridaz Featuring Gemini
So Sexy : Twista Featuring R. Kelly
Soldier : Destiny's Child Featuring T.I. & Lil Wayne
Solitaire : Clay Aiken
Some Beach : Blake Shelton
Some Cut : Trillville Featuring Cutty
Some Girls (Dance With Women) : JC Chasez Featuring Dirt McGirt
Somebody : Reba McEntire
Somebody Told Me : The Killers
Someday : Nickelback
Something Happened On The Way To Heaven : Deborah Cox
Songs About Rain : Gary Allan
Sorry 2004 : Ruben Studdard
Southside : Lloyd Featuring Ashanti
Splash Waterfalls : Ludacris
Stacy's Mom : Fountains Of Wayne
Stand Up : Ludacris Featuring Shawnna
Still In Love : Teena Marie Featuring Baby
Storm : Lenny Kravitz Featuring Jay-Z
Stunt 101 : G-Unit
Suga Suga : Baby Bash Featuring Frankie J
Sunshine : Lil' Flip Featuring Lea
Sweet Southern Comfort : Buddy Jewell
Take Me Out : Franz Ferdinand
Take My Breath Away : Jessica Simpson
Talk About Our Love : Brandy Featuring Kanye West
Tear It Up : Yung Wun Featuring DMX, Lil' Flip & David Banner
Tempted To Touch : Rupee
That's What She Gets For Loving Me : Brooks & Dunn
The First Cut Is The Deepest : Sheryl Crow
The Outsider : A Perfect Circle
The Reason : Hoobastank
The Set Up : Obie Trice Featuring Nate Dogg
The Voice Within : Christina Aguilera
The Way You Move : OutKast Featuring Sleepy Brown
This Love : Maroon5
This Way : Dilated Peoples Featuring Kanye West
Tilt Ya Head Back : Nelly & Christina Aguilera
Time's Up! : Jadakiss Featuring Nate Dogg
Tipsy : J-Kwon
Turn Me On : Kevin Lyttle Featuring Spragga Benz
U Make Me Wanna : Jadakiss Featuring Mariah Carey
U Should've Known Better : Monica
Unwell : matchbox twenty
Used To Love U : John Legend
Vertigo : U2
Vitamin R (Leading Us Along) : Chevelle
Walked Outta Heaven : Jagged Edge
Wanna Get To Know You : G-Unit Featuring Joe
Wat Da Hook Gon Be : Murphy Lee Featuring Jermaine Dupri
Wave On Wave : Pat Green
Welcome Back : Mase
Welcome Back : Mason Betha
Welcome To My Life : Simple Plan
Westside Story : The Game Featuring 50 Cent
What U Gon' Do : Lil Jon & The East Side Boyz Featuring Lil Scrappy
What You Waiting For? : Gwen Stefani
Whatever U Want : Christina Milian Featuring Joe Budden
Whats Happnin! : Ying Yang Twins Featuring Trick Daddy
When I Look To The Sky : Train
When The Sun Goes Down : Kenny Chesney & Uncle Kracker
Where Are We Runnin'? : Lenny Kravitz
Whiskey Girl : Toby Keith
Whiskey Lullaby : Brad Paisley Featuring Alison Krauss
White Flag : Dido
White Houses : Vanessa Carlton
White Tee's : Dem Franchize Boyz
Who Is She 2 U : Brandy
Whoknows : Musiq
Why Can't I : Liz Phair
Why Don't You & I : Santana Featuring Alex Band Or Chad Kroeger
Why? : Jadakiss Featuring Anthony Hamilton
Wild West Show : Big & Rich
Wonderful : Ja Rule Featuring R. Kelly & Ashanti
Work It (Reinvention) : Nelly
Yeah : Usher Featuring Ludacris & Lil Jon
Yeah! : Usher Featuring Lil Jon & Ludacris
You & Me : J-Kwon Featuring Sadiyyah
You : Ryan Duarte
You Raise Me Up : Josh Groban
You'll Think Of Me : Keith Urban
You're My Everything : Anita Baker
You're The One : Guerilla Black Featuring Mario Winans
You're The Only One : Maria Mena
