(You Want To) Make A Memory : Bon Jovi
1234 : Feist
1973 : James Blunt
1st Time : Yung Joc Featuring Marques Houston & Trey Songz
2 Step : Unk
4 In The Morning : Gwen Stefani
A Bay Bay : Hurricane Chris
A Different World : Bucky Covington
A Feelin' Like That : Gary Allan
A Great Big Sled : The Killers Featuring Toni Halliday
A Woman's Love : Alan Jackson
All My Friends Say : Luke Bryan
And I Am Telling You I'm Not Going : Jennifer Hudson
Anna-Molly : Incubus
Anonymous : Bobby Valentino Featuring Timbaland
Anyway : Martina McBride
Apologize : Timbaland Featuring One Republic
Apologize : Timbaland Featuring OneRepublic
As If : Sara Evans
Ay Chico (Lengua Afuera) : Pitbull
Ayo Technology : 50 Cent Featuring Justin Timberlake & Timbaland
Baby Don't Go : Fabolous Featuring Jermaine Dupri
Bartender : T-Pain Featuring Akon
Beautiful Flower : India.Arie
Beautiful Girls : Sean Kingston
Beautiful Liar : Beyonce & Shakira
Because Of You : Ne-Yo
Because Of You : Reba McEntire Duet With Kelly Clarkson
Bed : J. Holiday
Beer In Mexico : Kenny Chesney
Before He Cheats : Carrie Underwood
Before It's Too Late (Sam And Mikaela's Theme) : Goo Goo Dolls
Bet On It : Zac Efron
Better Than Me : Hinder
Big Girls Don't Cry : Fergie
Big Things Poppin' (Do It) : T.I.
Blue Magic : Jay-Z
Boston : Augustana
Break 'Em Off : Paul Wall Featuring Lil' KeKe
Break It Off : Rihanna & Sean Paul
Breath : Breaking Benjamin
Bubbly : Colbie Caillat
Buddy : Musiq Soulchild
Buy U A Drank (Shawty Snappin') : T-Pain Featuring Yung Joc
Calabria : Enur Featuring Natasja
Call Me When You're Sober : Evanescence
Can't Help But Wait : Trey Songz
Can't Leave 'Em Alone : Ciara Featuring 50 Cent
Candyman : Christina Aguilera
Chasing Cars : Snow Patrol
Chicken Noodle Soup. : Webstar & Young B Featuring The Voice Of Harlem
Circle : Marques Houston
Clothes Off!! : Gym Class Heroes
Coffee Shop : Yung Joc Featuring Gorilla Zoe
Come Back To Me : Vanessa Hudgens
Come To Me : Diddy Featuring Nicole Scherzinger
Crank That (Soulja Boy) : Soulja Boy
Crank That (Soulja Boy) : Soulja Boy Tell'em
Crazy Car : The Naked Brothers Band
Cupid Shuffle : Cupid
Cupid's Chokehold/Breakfast In America : Gym Class Heroes Featuring Patrick Stump
Cyclone : Baby Bash Featuring T-Pain
Dance Tonight : Paul McCartney
Dashboard : Modest Mouse
Dem Jeans : Chingy Featuring Jermaine Dupri
Diamonds : Fabolous Featuring Young Jeezy
Do It Just Like A Rockstar : Freak Nasty Featuring Crazy Mike
Do It Well : Jennifer Lopez
Do You Know? (The Ping Pong Song)/Dimelo : Enrique Iglesias
Doe Boy Fresh : Three 6 Mafia Featuring Chamillionaire
Don't Make Me : Blake Shelton
Don't Matter : Akon
Duffle Bag Boy : Playaz Circle Featuring Lil Wayne
Earth Intruders : Bjork
Easy : Paula DeAnda Featuring Bow Wow
Empty Walls : Serj Tankian
Everything : Michael Buble
Fabulous : Ashley Tisdale And Lucas Grabeel
Face Down : The Red Jumpsuit Apparatus
Fake It : Seether
Fall : Clay Walker
Famous In A Small Town : Miranda Lambert
Fidelity : Regina Spektor
Find Out Who Your Friends Are : Tracy Lawrence
Firecracker : Josh Turner
First Time : Lifehouse
Flashing Lights : Kanye West Featuring Dwele
Flathead : The Fratellis
Forever : Papa Roach
Freak On A Leash (Unplugged) : Korn Featuring Amy Lee
Freaky Gurl : Gucci Mane
From Yesterday : 30 Seconds To Mars
G.N.O. (Girl's Night Out) : Miley Cyrus
Get Buck : Young Buck
Get Buck In Here : DJ Felli Fel Featuring Diddy, Akon, Ludacris & Lil Jon
Get It Shawty : Lloyd
Gimme More : Britney Spears
Girlfriend : Avril Lavigne
Girlfriend : Bow Wow & Omarion
Give It To Me : Timbaland Featuring Nelly Furtado & Justin Timberlake
Glamorous : Fergie Featuring Ludacris
Go Getta : Young Jeezy Featuring R. Kelly
Go Girl : Pitbull Featuring Trina & Young Bo$$
Good Directions : Billy Currington
Good Life : Kanye West Featuring T-Pain
Grace Kelly : Mika
Guys Like Me : Eric Church
Hate That I Love You : Rihanna Featuring Ne-Yo
He Said She Said : Ashley Tisdale
Headlines (Friendship Never Ends) : Spice Girls
Here (In Your Arms) : Hellogoodbye
Here It Goes Again : OK Go
Hey There Delilah : Plain White T's
High Maintenance Woman : Toby Keith
Hip Hop Is Dead : Nas Featuring will.i.am
Home : Daughtry
Honestly : Cartel
Hood Figga : Gorilla Zoe
How Do I Breathe : Mario
How Far We've Come : matchbox twenty
How To Save A Life : The Fray
Hypnotized : Plies Featuring Akon
I Don't Dance : Corbin Bleu And Lucas Grabeel
I Don't Need A Man : The Pussycat Dolls
I Don't Wanna Be In Love (Dance Floor Anthem) : Good Charlotte
I Don't Wanna Stop : Ozzy Osbourne
I Got It From My Mama : will.i.am
I Loved Her First : Heartland
I Luv It : Young Jeezy
I Need You : Tim McGraw With Faith Hill
I Remember : Keyshia Cole
I Told You So : Keith Urban
I Tried : Bone Thugs-N-Harmony Featuring Akon
I Wanna Love You : Akon Featuring Snoop Dogg
I'll Wait For You : Joe Nichols
I'm A Flirt : Bow Wow Or R. Kelly (Featuring T.I. & T-Pain)
I'm A Flirt : R. Kelly Or Bow Wow (Featuring T.I. & T-Pain)
I'm So Hood : DJ Khaled Featuring T-Pain, Trick Daddy, Rick Ross & Plies
I'm Throwed : Paul Wall Featuring Jermaine Dupri
Ice Box : Omarion
Icky Thump : The White Stripes
If Everyone Cared : Nickelback
If I Was Your Man : Joe
If We Were A Movie : Hannah Montana
Imagine : Jack Johnson
Impacto : Daddy Yankee Featuring Fergie
Inconsolable : Backstreet Boys
Independent : Webbie, Lil' Phat & Lil' Boosie
Int'l Players Anthem (I Choose You) : UGK Featuring OutKast
Into The Night : Santana Featuring Chad Kroeger
Into The Ocean : Blue October
Irreplaceable : Beyonce
It Ends Tonight : The All-American Rejects
Johnny Cash : Jason Aldean
Jump To The Rhythm : Jordan Pruitt
Just Fine : Mary J. Blige
Keep Your Mind Wide Open : AnnaSophia Robb
King Kong : Jibbs Featuring Chamillionaire
Kiss Kiss : Chris Brown Featuring T-Pain
Ladies Love Country Boys : Trace Adkins
Last Dollar (Fly Away) : Tim McGraw
Last Night : Diddy Featuring Keyshia Cole
Lean Like A Cholo : Down A.K.A. Kilo
Lean Like A Cholo : Down AKA Kilo
Let It Go : Keyshia Cole Featuring Missy Elliott & Lil Kim
Like A Boy : Ciara
Like A Star : Corinne Bailey Rae
Like This : Kelly Rowland Featuring Eve
Lip Gloss : Lil Mama
Lips Of An Angel : Jack Ingram
Little Bit Of Life : Craig Morgan
Little Wonders : Rob Thomas
Livin' Our Love Song : Jason Michael Carroll
Long Trip Alone : Dierks Bentley
Lost : Faith Hill
Lost In This Moment : Big & Rich
Lost One : Jay-Z Featuring Chrisette Michele
Lost Without U : Robin Thicke
Love Like This : Natasha Bedingfield Featuring Sean Kingston
Love Like Winter : AFI
Love Me Or Hate Me (F**k You!!!!) : Lady Sovereign
Love Song : Sara Bareilles
Low : Flo Rida Featuring T-Pain
Lucky Man : Montgomery Gentry
Make It Rain : Fat Joe Featuring Lil Wayne
Make Me Better : Fabolous Featuring Ne-Yo
Makes Me Wonder : Maroon 5
Makes Me Wonder : Maroon5
Me Enamora : Juanes
Misery Business : Paramore
Moments : Emerson Drive
Money In The Bank : Lil Scrappy Featuring Young Buck
Money In The Bank : Swizz Beatz
Money Maker : Ludacris Featuring Pharrell
More Than A Memory : Garth Brooks
Mr. Jones : Mike Jones
Music Is My Hot Hot Sex : CSS
My Drink N' My 2 Step : Cassidy Featuring Swizz Beatz
My Love : Justin Timberlake Featuring T.I.
My, Oh My : The Wreckers
Never : Jaheim
Never Again : Kelly Clarkson
Never Too Late : Three Days Grace
No One : Alicia Keys
Not Fade Away : Sheryl Crow
Not Ready To Make Nice : Dixie Chicks
Nothin' Better To Do : LeAnn Rimes
Nothing Left To Lose : Mat Kearney
On The Hotline : Pretty Ricky
One Wing In The Fire : Trent Tomlinson
Outta My System : Bow Wow Featuring T-Pain & Johnta Austin
Over It : Katharine McPhee
Paralyzer : Finger Eleven
Party Like A Rockstar : Shop Boyz
Phantom Limb : The Shins
Pictures Of You : The Last Goodnight
Please Don't Go : Tank
Pop Bottles : Birdman Featuring Lil Wayne
Pop, Lock & Drop It : Huey
Poppin' : Chris Brown Featuring Jay Biz
Potential Breakup Song : Aly & AJ
Proud Of The House We Built : Brooks & Dunn
Push It To The Limit : Corbin Bleu
Read My Mind : The Killers
Ready, Set, Don't Go : Billy Ray Cyrus
Ready, Set, Don't Go : Billy Ray Cyrus With Miley Cyrus
Red High Heels : Kellie Pickler
Rehab : Amy Winehouse
Release : Timbaland Featuring Justin Timberlake
River : Sarah McLachlan
Rock Yo Hips : Crime Mob Featuring Lil Scrappy
Runaway Love : Ludacris Featuring Mary J. Blige
S.O.S. : Jonas Brothers
Same Girl : R. Kelly Duet With Usher
Save Room : John Legend
Say It Right : Nelly Furtado
Sensual Seduction : Snoop Dogg
Settlin' : Sugarland
Sexy Lady : Yung Berg Featuring Junior
Sexy Movimiento : Wisin & Yandel
Shawty : Plies Featuring T-Pain
Shawty Is A 10 : The-Dream
She's Like The Wind : Lumidee Featuring Tony Sunshine
Shortie Like Mine : Bow Wow Featuring Chris Brown & Johnta Austin
Shoulda Let You Go : Keyshia Cole Introducing Amina
Show Me The Money : Petey Pablo
Show Stopper : Danity Kane
Shut Up And Drive : Rihanna
Smack That : Akon Featuring Eminem
Smile : Lily Allen
Snow ((Hey Oh)) : Red Hot Chili Peppers
Sorry : Buckcherry
Soulja Girl : Soulja Boy Tell'em Featuring I-15
Stand : Rascal Flatts
Startin' With Me : Jake Owen
Stealing Cinderella : Chuck Wicks
Still Will : 50 Cent Featuring Akon
Stolen : Dashboard Confessional
Stop And Stare : OneRepublic
Straight To The Bank : 50 Cent
Stronger : Kanye West
Stuntin' Like My Daddy : Birdman & Lil Wayne
Suddenly I See : KT Tunstall
Summer Love : Justin Timberlake
Superstar : Lupe Fiasco Featuring Matthew Santos
Survivalism : Nine Inch Nails
Sweetest Girl (Dollar Bill) : Wyclef Jean Featuring Akon, Lil Wayne & Niia
Taking Chances : Celine Dion
Tambourine : Eve
Tarantula : The Smashing Pumpkins
Tattoo : Jordin Sparks
Teardrops On My Guitar : Taylor Swift
Teenagers : My Chemical Romance
Tell Me 'Bout It : Joss Stone
Tell Me : Diddy Featuring Christina Aguilera
That's That : Snoop Dogg Featuring R. Kelly
The Great Escape : Boys Like Girls
The Hand Clap : Hurricane Chris Featuring Big Poppa
The Pretender : Foo Fighters
The River : Good Charlotte Featuring M. Shadows And Synyster Gates
The Saints Are Coming : U2 & Green Day
The Story : Brandi Carlile
The Sweet Escape : Gwen Stefani Featuring Akon
The Way I Am : Ingrid Michaelson
The Way I Are : Timbaland Featuring Keri Hilson
The Way I Live : Baby Boy Da Prince Featuring Lil Boosie
These Are My People : Rodney Atkins
Thinking About You : Norah Jones
This Is Why I'm Hot : Mims
Thnks Fr Th Mmrs : Fall Out Boy
Through Glass : Stone Sour
Throw Some D's : Rich Boy Featuring Polow Da Don
Ticks : Brad Paisley
Too Little Too Late : JoJo
Tu Amor : RBD
U + Ur Hand : Pink
Umbrella : Rihanna Featuring Jay-Z
Unappreciated : Cherish
Until The End Of Time : Justin Timberlake Duet With Beyonce
Up To The Mountain : Kelly Clarkson Featuring Jeff Beck
Upgrade U : Beyonce Featuring Jay-Z
Vulnerable : Secondhand Serenade
Wadsyaname : Nelly
Wait A Minute : The Pussycat Dolls Featuring Timbaland
Wait For You : Elliott Yamin
Waiting On The World To Change : John Mayer
Walk Away (Remember Me) : Paula DeAnda Featuring The DEY
Wall To Wall : Chris Brown
We Fly High : Jim Jones
We Takin' Over : DJ Khaled Featuring T.I. Akon, Rick Ross, Fat Joe. Lil' Wayne & Baby
We Takin' Over : DJ Khaled Featuring T.I. Akon, Rick Ross, Fat Joe. Lil' Wayne, Baby
We Takin' Over : DJ Khaled Featuring T.I., Akon, Rick Ross, Fat Joe, Lil' Wayne & Baby
What I've Done : Linkin Park
What Time Is It : High School Musical 2 Cast
When I See U : Fantasia
Whine Up : Kat Deluna Featuring Elephant Man
White & Nerdy : Weird Al Yankovic
Wipe Me Down : Lil Boosie Featuring Foxx & Webbie
With Love : Hilary Duff
Working Class Hero : Green Day
Wouldn't Get Far : The Game Featuring Kanye West
Wrapped : George Strait
You : Lloyd Featuring Lil' Wayne
You Are The Music In Me : Zac Efron & Vanessa Anne Hudgens
You Are The Music In Me : Zac Efron And Vanessa Anne Hudgens
You Are The Music In Me : Zac Efron/Vanessa Anne Hudgens
You Can't Stop The Beat : Cast Of Hairspray
You Don't Know : Eminem, 50 Cent, Lloyd Banks & Cashis
You Give Love A Bad Name : Blake Lewis
You Know I'm No Good : Amy Winehouse Featuring Ghostface Killah
You Know What It Is : T.I. Featuring Wyclef Jean
You Raise Me Up : Josh Groban & The African Children's Choir
Zoom : Lil' Boosie Featuring Yung Joc
