(It) Feels So Good : Steven Tyler
5 O'Clock : T-Pain Featuring Wiz Khalifa & Lily Allen
6 Foot 7 Foot : Lil Wayne Featuring Cory Gunz
9 Piece : Rick Ross Featuring Lil Wayne Or T.I.
A Little Bit Stronger : Sara Evans
A Thousand Years : Christina Perri
A Woman Like You : Lee Brice
Afraid To Sleep : Vicci Martinez
After Midnight : Blink-182
All I Want For Christmas Is You (SuperFestive!) : Justin Bieber Duet With Mariah Carey
All I Want For Christmas Is You : Michael Buble
All I Want Is You : Miguel Featuring J. Cole
All Of The Lights : Kanye West
Alone With You : Jake Owen
Ambition : Wale Featuring Meek Mill & Rick Ross
Amen : Edens Edge
Angel : Akon
Animal : Neon Trees
Anything Like Me : Brad Paisley
As She's Walking Away : Zac Brown Band Featuring Alan Jackson
Ass Back Home : Gym Class Heroes Featuring Neon Hitch
Aston Martin Music : Rick Ross Featuring Drake & Chrisette Michele
Baby, It's Cold Outside : Glee Cast
Backseat : New Boyz Featuring The Cataracs & Dev
Baggage Claim : Miranda Lambert
Bait A Hook : Justin Moore
Ballin' : Young Jeezy Featuring Lil Wayne
Bang Bang Pow Pow : T-Pain Featuring Lil Wayne
Barbra Streisand : Duck Sauce
Bass Down Low : Dev Featuring The Cataracs
Beautiful : Christina Aguilera & Beverly McClellan
Beautiful Lasers (2 Ways) : Lupe Fiasco Featuring MDMA
Beautiful People : Chris Brown Featuring Benny Benassi
Best Love Song : T-Pain Featuring Chris Brown
Better With The Lights Off : New Boyz Feat. Chris Brown
Better With The Lights Off : New Boyz Featuring Chris Brown
Black And Yellow : Wiz Khalifa
Black Horse And The Cherry Tree : Casey Weston
Blackout : Breathe Carolina
Body 2 Body : Ace Hood Featuring Chris Brown
Body And Soul : Tony Bennett & Amy Winehouse
Boom : Snoop Dogg Featuring T-Pain
Booty Wurk (One Cheek At A Time) : T-Pain Featuring Joey Galaxy
Bottoms Up : Trey Songz Featuring Nicki Minaj
Bow Chicka Wow Wow : Mike Posner Featuring Lil Wayne
Boyfriend : Big Time Rush
Boyfriend : New Hollow
Brighter Than The Sun : Colbie Caillat
Buzzin' : Mann
Buzzin' : Mann Featuring 50 Cent
Calling All The Monsters : China Anne McClain
Can't Be Friends : Trey Songz
Can't Get Enough : J. Cole Featuring Trey Songz
Cat Daddy : Rej3ctz
Check It Out : will.i.am & Nicki Minaj
Cheers (Drink To That) : Rihanna
Christmas Song (Chestnuts Roasting On An Open Fire) : Justin Bieber Featuring Usher
Closer To The Edge : Thirty Seconds To Mars
Club Can't Handle Me : Flo Rida Featuring David Guetta
Come Home : Faith Hill
Coming Home : Diddy - Dirty Money Featuring Skylar Grey
Cost Of Livin' : Ronnie Dunn
Countdown : Beyonce
Country Boy : Aaron Lewis Featuring George Jones & Charlie Daniels
Country Must Be Country Wide : Brantley Gilbert
Country Song : Seether
Country Strong : Gwyneth Paltrow
Crawling Back To You : Daughtry
Crazy Girl : Eli Young Band
DJ Got Us Fallin' In Love : Usher Featuring Pitbull
Dance (A$$) : Big Sean
Dance (A$$) : Big Sean Featuring Nicki Minaj
Dancing Crazy : Miranda Cosgrove
Danza Kuduro : Don Omar & Lucenzo
Dedication To My Ex (Miss That) : Lloyd Featuring Andre 3000 & Lil Wayne
Determinate : Bridgit Mendler, Adam Hicks, Naomi Scott & Hayley Kiyoko
Deuces : Chris Brown Featuring Tyga & Kevin McCall
Dirt Road Anthem : Jason Aldean Featuring Ludacris
Dirty Dancer : Enrique Iglesias With Usher Featuring Lil Wayne
Dirty Dancer : Enrique Iglesias Wtih Usher Featuring Lil Wayne
Disaster : JoJo
Do The John Wall : Troop 41
Dog Days Are Over : Florence + The Machine
Domino : Jessie J
Don't Hold Your Breath : Nicole Scherzinger
Don't You Wanna Stay : Jason Aldean With Kelly Clarkson
Donald Trump : Mac Miller
Down On Me : Jeremih Featuring 50 Cent
Dreams : Glee Cast Featuring Kristin Chenoweth
Drink In My Hand : Eric Church
Drummer Boy : Justin Bieber Featuring Busta Rhymes
Dynamite : Taio Cruz
E.T. : Katy Perry Featuring Kanye West
Easy : Rascal Flatts Featuring Natasha Bedingfield
El Verdadero Amor Perdona : Mana Featuring Prince Royce
F**k You (Forget You) : Cee Lo Green
Fall For Your Type : Jamie Foxx Featuring Drake
Far Away : Marsha Ambrosius
Far Away : Tyga Featuring Chris Richardson
Fast Lane : Bad Meets Evil
Faster : Matt Nathanson
Felt Good On My Lips : Tim McGraw
Fire Flame : Birdman Featuring Lil Wayne
First Of The Year (Equinox) : Skrillex
Fish : Craig Campbell
Fly : Nicki Minaj Featuring Rihanna
Focused : Wale Featuring Kid Cudi
For You, And Your Denial : Yellowcard
Freak The Freak Out : Victorious Cast Featuring Victoria Justice
Friday : Rebecca Black
From A Table Away : Sunny Sweeney
Georgia Clay : Josh Kelley
Give In To Me : Garrett Hedlund & Leighton Meester
Give Me Everything : Pitbull Featuring Ne-Yo, Afrojack & Nayer
God Gave Me You : Blake Shelton
Good Feeling : Flo Rida
Good Good Night : Roscoe Dash
Good Life : OneRepublic
Got 2 Luv U : Sean Paul Featuring Alexis Jordan
Grove St. Party : Waka Flocka Flame Featuring Kebo Gotti
Gucci Gucci : Kreayshawn
H*A*M : Kanye West & Jay-Z
Hangover : Taio Cruz Featuring Flo Rida
Headlines : Drake
Heartbeat : The Fray
Hell On Heels : Pistol Annies
Hello : Martin Solveig & Dragonette
Help Is On The Way : Rise Against
Here For A Good Time : George Strait
Hey Baby (Drop It To The Floor) : Pitbull Featuring T-Pain
High : Big Sean Featuring Wiz Khalifa
Higher : Taio Cruz Featuring Travie McCoy
Hit It Again : 3OH!3
Hit The Lights : Jay Sean Featuring Lil Wayne
Hold My Hand : Michael Jackson Duet With Akon
Home : Dierks Bentley
How To Hate : Lil Wayne Featuring T-Pain
How To Love : Lil Wayne
Hustle Hard : Ace Hood
I Am The Champion : B.o.B
I Am Woman : Jordin Sparks
I Can't Love You Back : Easton Corbin
I Don't Want This Night To End : Luke Bryan
I Got Nothin' : Darius Rucker
I Got You : Thompson Square
I Just Had Sex : The Lonely Island Featuring Akon
I Like How It Feels : Enrique Iglesias Featuring Pitbull & The WAV.s
I Like It : Enrique Iglesias Featuring Pitbull
I Like It Like That : Hot Chelle Rae Featuring New Boyz
I Need A Doctor : Dr. Dre Featuring Eminem & Skylar Grey
I Smile : Kirk Franklin
I Wanna Go : Britney Spears
I Won't Back Down : Blake Shelton & Dia Frampton
I Won't Give Up : Jana Kramer
I Wouldn't Be A Man : Josh Turner
I'm Flexin' : T.I. Featuring Big K.R.I.T.
I'm Gonna Love You Through It : Martina McBride
I'm Into You : Jennifer Lopez Featuring Lil Wayne
I'm On One : DJ Khaled Featuring Drake, Rick Ross & Lil Wayne
If I Die Young : The Band Perry
In The Dark : Dev
International Love : Pitbull Featuring Chris Brown
Inventing Shadows : Dia Frampton
It Girl : Jason Derulo
It Will Rain : Bruno Mars
It's Good : Lil Wayne Featuring Drake & Jadakiss
Jack Sparrow : The Lonely Island Featuring Michael Bolton
John : Lil Wayne Featuring Rick Ross
Just A Dream : Nelly
Just A Kiss : Lady Antebellum
Just Fishin' : Trace Adkins
Keep Me In Mind : Zac Brown Band
Keep Your Head Up : Andy Grammer
Knee Deep : Zac Brown Band Featuring Jimmy Buffett
Kush : Dr. Dre Featuring Snoop Dogg & Akon
Last Friday Night (T.G.I.F.) : Katy Perry
Lay It Down : Lloyd
Lessons In Love : Kaskade Featuring Neon Trees
Let It Rain : David Nail
Let Me Down Easy : Billy Currington
Letting Go (Dutty Love) : Sean Kingston Featuring Nicki Minaj
Levels : Avicii
Lighters : Bad Meets Evil Featuring Bruno Mars
Lights : Ellie Goulding
Like A G6 : Far*East Movement Featuring Cataracs & Dev
Like My Mother Does : Lauren Alaina
Little Bad Girl : David Guetta Featuring Taio Cruz & Ludacris
Little Lion Man : Mumford & Sons
Lo Mejor De Mi Vida Eres Tu : Ricky Martin Featuring Natalia Jimenez
Loca : Shakira Featuring El Cata or Dizzee Rascal
Long Hot Summer : Keith Urban
Look At Me Now : Chris Brown Featuring Lil Wayne & Busta Rhymes
Look It Up : Ashton Shepherd
Lost In Paradise : Evanescence
Lotus Flower Bomb : Wale Featuring Miguel
Love Don't Run : Steve Holy
Love Like Woe : The Ready Set
Love The Way You Lie : Eminem Featuring Rihanna
Love You Like A Love Song : Selena Gomez & The Scene
Loving You No More : Diddy - Dirty Money Featuring Drake
Made In America : Toby Keith
Make A Movie : Twista Featuring Chris Brown
Make It Rain : Travis Porter
Make Me Proud : Drake Featuring Nicki Minaj
Mama's Song : Carrie Underwood
Man In The Mirror : Adam Levine & Javier Colon
Marry Me : Train
Martians Vs Goblins : Game
Marvin & Chardonnay : Big Sean Featuring Kanye West & Roscoe Dash
Maybe : Sick Puppies
Memories : David Guetta Featuring Kid Cudi
Mirror : Lil Wayne Featuring Bruno Mars
Mistletoe : Justin Bieber
Moment 4 Life : Nicki Minaj Featuring Drake
Monster : Kanye West Featuring Jay-Z, Rick Ross, Bon Iver & Nicki Minaj
Monster : Paramore
More : Usher
Motivation : Kelly Rowland Featuring Lil Wayne
Moves Like Jagger : Maroon 5 Featuring Christina Aguilera
Mr. Know It All : Kelly Clarkson
Mr. Saxobeat : Alexandra Stan
Mrs. Right : Mindless Behavior Featuring Diggy
My Body : Young The Giant
My Last : Big Sean Featuring Chris Brown
Never Gonna Leave This Bed : Maroon 5
Never Say Never : Justin Bieber Featuring Jaden Smith
Next To You : Chris Brown Featuring Justin Bieber
Ni**as in Paris : Jay Z Kanye West
Night Of Your Life : David Guetta Featuring Jennifer Hudson
No Hands : Waka Flocka Flame Featuring Roscoe Dash & Wale
No Love : Eminem Featuring Lil Wayne
Not Over You : Gavin DeGraw
Not Ready To Die : Avenged Sevenfold
Nothing : The Script
Novacane : Frank Ocean
Oh My : DJ Drama Featuring Fabolous, Roscoe Dash & Wiz Khalifa
Oh Santa! : Mariah Carey
Old Alabama : Brad Paisley Featuring Alabama
On My Level : Wiz Khalifa Featuring Too $hort
On The Floor : Jennifer Lopez Featuring Pitbull
One More Drinkin' Song : Jerrod Niemann
Opposite Of Adults : Chiddy Bang
Otis : Jay Z Kanye West Featuring Otis Redding
Otis : Jay-Z & Kanye West Featuring Otis Redding
Out Of My Head : Lupe Fiasco Featuring Trey Songz
Outlaw : 50 Cent
Papi : Jennifer Lopez
Paradise : Coldplay
Party : Beyonce Featuring Andre 3000
Party Rock Anthem : LMFAO Featuring Lauren Bennett & GoonRock
Pause : Pitbull
Please Don't Go : Mike Posner
Police Dog Blues : Hugh Laurie
Porn Star Dancing : My Darkest Days Featuring Zakk Wylde
Pretty Girl Rock : Keri Hilson
Pretty Girls : Iyaz
Pretty Girls : Iyaz Featuring Travie McCoy
Price Tag : Jessie J Featuring B.o.B
Price Tag : Xenia
Princess Of China : Coldplay Featuring Rihanna
Promise : Romeo Santos Featuring Usher
Pumped Up Kicks : Foster The People
Pursuit Of Happiness (Nightmare) : Kid Cudi Featuring MGMT & Ratatat
Quickie : Miguel
Rack City : Tyga
Racks : YC Featuring Future
Rain Over Me : Pitbull Featuring Marc Anthony
Raise Your Glass : P!nk
Red Nation : Game Featuring Lil Wayne
Remind Me : Brad Paisley Duet With Carrie Underwood
Rhythm of Love : Plain White T's
Right There : Nicole Scherzinger Featuring 50 Cent
Rise Above 1 : Reeve Carney Featuring Bono & The Edge
Rocketeer : Far*East Movement Featuring Ryan Tedder
Rolling In The Deep : Glee Cast Featuring Jonathan Groff
Roman's Revenge : Nicki Minaj Featuring Eminem
Round Of Applause : Waka Flocka Flame Featuring Drake
Run : Matt Nathanson Featuring Sugarland
Runaway : Kanye West Featuring Pusha T
S&M : Rihanna Featuring Britney Spears
Sail : AWOLNATION
See No More : Joe Jonas
Sexy And I Know It : LMFAO
Shake : Jesse McCartney
Shake Me Down : Cage The Elephant
Shake Senora : Pitbull Featuring T-Pain & Sean Paul
She Will : Lil Wayne Featuring Drake
Ships In The Night : Mat Kearney
Sing : My Chemical Romance
Skyscraper : Demi Lovato
Sleazy Remix 2.0 Get Sleazier : Ke$ha Featuring Lil Wayne, Wiz Khalifa, T.I. & Andre 3000
So In Love : Jill Scott Featuring Anthony Hamilton
So Special : Lil Wayne Featuring John Legend
Somebody : Bridgit Mendler
Someone Like You : Adele
Somewhere With You : Kenny Chesney
Sparks Fly : Taylor Swift
Stay The Night : James Blunt
Stereo Hearts : Gym Class Heroes Featuring Adam Levine
Stereo Love : Edward Maya & Vika Jigulina
Still Got It : Tyga Featuring Drake
Stitch By Stitch : Javier Colon
Storm Warning : Hunter Hayes
Strange Clouds : B.o.B Featuring Lil Wayne
Strip : Chris Brown Featuring Kevin McCall
Stuck Like Glue : Sugarland
Super Bass : Nicki Minaj
Sweat : Bow Wow Featuring Lil Wayne
T.H.E. (The Hardest Ever) : will.i.am Featuring Mick Jagger & Jennifer Lopez
Taboo : Don Omar
Take A Back Road : Rodney Atkins
Take Care : Drake Featuring Rihanna
Take Over Control : Afrojack Featuring Eva Simons
Talk That Talk : Rihanna Featuring Jay-Z
Tattoos On This Town : Jason Aldean
That Way : Wale Featuring Jeremih & Rick Ross
That's All She Wrote : T.I. Featuring Eminem
The Adventures Of Rain Dance Maggie : Red Hot Chili Peppers
The Ballad Of Mona Lisa : Panic! At The Disco
The Creep : The Lonely Island Featuring Nicki Minaj
The Motto : Drake Featuring Lil Wayne
The Shape I'm In : Joe Nichols
The Show Goes On : Lupe Fiasco
The Story : Sara Ramirez
The Time (Dirty Bit) : The Black Eyed Peas
The Trouble With Girls : Scotty McCreery
Tighten Up : The Black Keys
Till I'm Gone : Tinie Tempah Featuring Wiz Khalifa
Till The World Ends : Britney Spears Featuring Nicki Minaj & Ke$ha
Titanium : David Guetta Featuring Sia
Today Is Your Day : Shania Twain
Tongue Tied : Grouplove
Tonight (I'm Lovin' You) : Enrique Iglesias Featuring Ludacris & DJ Frank E
Tonight Is The Night : Outasight
Tonight Tonight : Hot Chelle Rae
Turn Me On : David Guetta Featuring Nicki Minaj
Turn On The Radio : Reba
Turning Tables : Glee Cast Featuring Gwyneth Paltrow
Twisted : Gorilla Zoe Featuring Lil Jon
Under And Over It : Five Finger Death Punch
Unusual : Trey Songz Featuring Drake
Waiting For The End : Linkin Park
Walk : Foo Fighters
Walking : Mary Mary
Watch Me : Bella Thorne & Zendaya
We Are Young : Fun. Featuring Janelle Monae
We Don't Get Down Like Y'all : T.I. Featuring B.o.B.
We Found Love : Rihanna Featuring Calvin Harris
We No Speak Americano : Yolanda Be Cool & Dcup
We R Who We R : Ke$ha
We'll Be Fine : Drake Featuring Birdman
Welcome To My Hood : DJ Khaled Featuring Rick Ross, Plies, Lil Wayne & T-Pain
Wet The Bed : Chris Brown Feat. Ludacris
What Are Words : Chris Medina
What The Hell : Avril Lavigne
What's My Name? : Rihanna Featuring Drake
When A Woman Loves : R. Kelly
When We Stand Together : Nickelback
When You're Young : 3 Doors Down
Where Them Girls At : David Guetta Featuring Flo Rida & Nicki Minaj
Where You At : Jennifer Hudson
Whip My Hair : Willow
Who Dat Girl : Flo Rida Featuring Akon
Who's That Chick? : David Guetta Featuring Rihanna
Why Wait : Rascal Flatts
Wildflower : The JaneDear Girls
Without You : David Guetta Featuring Usher
Words I Never Said : Lupe Fiasco Featuring Skylar Grey
Work Out : J. Cole
Written In The Stars : Tinie Tempah Featuring Eric Turner
Y.U. MAD : Birdman Featuring Nicki Minaj & Lil Wayne
Yeah 3X : Chris Brown
You : Chris Young
You : Romeo Santos
You And I : Lady Gaga
You And Tequila : Kenny Chesney Featuring Grace Potter
You Be Killin Em : Fabolous
You Make Me Feel... : Cobra Starship Featuring Sabi
You The Boss : Rick Ross Featuring Nicki Minaj
Young, Wild & Free : Snoop Dogg & Wiz Khalifa Featuring Bruno Mars
