(Kissed You) Good Night : Gloriana
2 Reasons : Trey Songz Featuring T.I.
4 AM : Melanie Fiona
5 O'Clock : T-Pain Featuring Wiz Khalifa & Lily Allen
5-1-5-0 : Dierks Bentley
99 Problems : Tony Lucca
A Thousand Years (Part 2) : Christina Perri Featuring Steve Kazee
A Thousand Years : Christina Perri
Adorn : Miguel
Ai Se Eu Te Pego : Michel Telo
All Around The World : Justin Bieber Featuring Ludacris
All Gold Everything : Trinidad James
All I Want For Christmas Is You : Mariah Carey
Amen : Edens Edge
Amen : Meek Mill Featuring Drake
Angel Eyes : Love And Theft
Another Round : Fat Joe Featuring Chris Brown
Around My Way (Freedom Ain't Free) : Lupe Fiasco
As Long As You Love Me : Justin Bieber Featuring Big Sean
Ass Back Home : Gym Class Heroes Featuring Neon Hitch
Ayy Ladies : Travis Porter Featuring Tyga
Back In Time : Pitbull
Bag Of Money : Wale Featuring Rick Ross, Meek Mill & T-Pain
Bag Of Money : Wale Featuring Rick Ross, Meek Mill, & T-Pain
Ball : T.I. Featuring Lil Wayne
Bandz A Make Her Dance : Juicy J Featuring Lil Wayne & 2 Chainz
Bangarang : Skrillex Featuring Sirah
Banjo : Rascal Flatts
Battle Scars : Lupe Fiasco & Guy Sebastian
Beautiful : Carly Rae Jepsen Featuring Justin Bieber
Beauty And A Beat : Justin Bieber Featuring Nicki Minaj
Beers Ago : Toby Keith
Beez In The Trap : Nicki Minaj Featuring 2 Chainz
Better Dig Two : The Band Perry
Better Than I Know Myself : Adam Lambert
Better Than I Used To Be : Tim McGraw
Between The Raindrops : Lifehouse Featuring Natasha Bedingfield
Birthday Cake : Rihanna Featuring Chris Brown
Birthday Song : 2 Chainz Featuring Kanye West
Blackout : Breathe Carolina
Blow Me (One Last Kiss) : P!nk
Blunt Blowin : Lil Wayne
Both Of Us : B.o.B Featuring Taylor Swift
Boyfriend : Justin Bieber
Brighter Than The Sun : Colbie Caillat
Brokenhearted : Karmin
Bully : Shinedown
Burn It Down : Linkin Park
Call Me Maybe : Carly Rae Jepsen
Called Out In The Dark : Snow Patrol
Can't Get Enough : J. Cole Featuring Trey Songz
Cashin Out : Ca$hOut
Cashin' Out : Ca$h Out
Celebration : Game Featuring Chris Brown, Tyga, Wiz Khalifa & Lil Wayne
Climax : Usher
Clique : Kanye West Jay-Z Big Sean
Clique : Kanye West, Jay-Z, Big Sean
Come Away To The Water : Maroon 5 Featuring Rozzi Crane
Cough Syrup : Young The Giant
Cowboys And Angels : Dustin Lynch
Crawling Back To You : Daughtry
Crew Love : Drake Featuring The Weekend
Crew Love : Drake Featuring The Weeknd
Cruise : Florida Georgia Line
Dance (A$$) : Big Sean Featuring Nicki Minaj
Dance Again : Jennifer Lopez Featuring Pitbull
Dance For You : Beyonce
Dancin' Away With My Heart : Lady Antebellum
Diced Pineapples : Rick Ross Featuring Wale & Drake
Did It For The Girl : Greg Bates
Die Young : Ke$ha
Do It Like You : Diggy Featuring Jeremih
Domino : Jessie J
Don't Rush : Kelly Clarkson Featuring Vince Gill
Don't Stop (Color On The Walls) : Foster The People
Don't Stop The Party : Pitbull Featuring TJR
Don't You Worry Child : Swedish House Mafia Feat. John Martin
Don't You Worry Child : Swedish House Mafia Featuring John Martin
Drank In My Cup : Kirko Bangz
Drink On It : Blake Shelton
Drive By : Train
Drummer Boy : Justin Bieber Featuring Busta Rhymes
Drunk On You : Luke Bryan
Easy : Rascal Flatts Featuring Natasha Bedingfield
El Cerrito Place : Kenny Chesney
Enough Of No Love : Keyshia Cole Featuring Lil Wayne
Even If It Breaks Your Heart : Eli Young Band
Every Storm (Runs Out Of Rain) : Gary Allan
Everybody Talks : Neon Trees
Everything Has Changed : Taylor Swift Featuring Ed Sheeran
Eyes Open : Taylor Swift
Eyes Wide Open : Gotye
F**kin Problems : A$AP Rocky Featuring Drake, 2 Chainz & Kendrick Lamar
Fade Into You : Sam Palladio & Clare Bowen
Faded : Tyga Featuring Lil Wayne
Feel Again : OneRepublic
Feel Like A Rock Star : Kenny Chesney & Tim McGraw
Feel So Close : Calvin Harris
Finally Found You : Enrique Iglesias Featuring Sammy Adams
Fine By Me : Andy Grammer
Fly : Nicki Minaj Featuring Rihanna
Fly Over States : Jason Aldean
For You : Keith Urban
Gangnam Style : PSY
Get It Started : Pitbull Featuring Shakira
Get Low : Waka Flocka Flame Featuring Nicki Minaj, Tyga & Flo Rida
Girl On Fire : Alicia Keys Featuring Nicki Minaj
Give Me All Your Luvin' : Madonna Featuring Nicki Minaj & M.I.A.
Give Me Everything : Pitbull Featuring Ne-Yo, Afrojack & Nayer
Give Your Heart A Break : Demi Lovato
Glad You Came : The Wanted
Glass : Thompson Square
Good Feeling : Flo Rida
Good Girl : Carrie Underwood
Good Good Night : Roscoe Dash
Good Time : Owl City & Carly Rae Jepsen
Got My Country On : Chris Cagle
Guap : Big Sean
Hall Of Fame : The Script Featuring will.i.am
Hard To Love : Lee Brice
Headlines : Drake
Heart Attack : Trey Songz
Heart Skips A Beat : Olly Murs Featuring Chiddy Bang
Heartbeat : The Fray
Ho Hey : The Lumineers
Home : Phillip Phillips
How Country Feels : Randy Houser
How We Do (Party) : Rita Ora
I Believe I Can Fly : Jermaine Paul
I Can Only Imagine : David Guetta Featuring Chris Brown & Lil Wayne
I Do : Young Jeezy Featuring Jay-Z & Andre 3000
I Don't Like : Chief Keef Featuring Lil Reese
I Dont Really Care : Waka Flocka Flame Featuring Trey Songz
I Like It Like That : Hot Chelle Rae Featuring New Boyz
I Want To Know What Love Is : Terry McDermott
I Will Always Love You : Glee Cast
I Will Always Love You : Whitney Houston
I Will Wait : Mumford & Sons
I Wish You Would : DJ Khaled Featuring Kanye West & Rick Ross
I Won't Give Up : Jason Mraz
I'm All Yours : Jay Sean Featuring Pitbull
I'm Different : 2 Chainz
I'm Gonna Love You Through It : Martina McBride
Ice : Kelly Rowland Featuring Lil Wayne
Ima Boss : Meek Mill Featuring T.I., Birdman Lil Wayne, DJ Khaled, Rick Ross & Swizz Beatz
Ima Boss : Meek Mill Featuring T.I., Birdman, Lil Wayne, DJ Khaled, Rick Ross & Swizz Beatz
International Love : Pitbull Featuring Chris Brown
Is Anybody Out There? : K'Naan Featuring Nelly Furtado
It Girl : Jason Derulo
It's Time : Imagine Dragons
Just A Fool : Christina Aguilera With Blake Shelton
Just What I Am : Kid Cudi Featuring King Chip
Leave You Alone : Young Jeezy Featuring Ne-Yo
Lemme See : Usher Featuring Rick Ross
Let It Go : Wiz Khalifa Featuring Akon
Let It Rain : David Nail
Let It Rain : David Nail Featuring Sarah Buxton
Let Me Love You (Until You Learn To Love Yourself) : Ne-Yo
Let's Go : Calvin Harris Featuring Ne-Yo
Levels : Avicii
Lights : Ellie Goulding
Little Talks : Of Monsters And Men
Live My Life : Far*East Movement Featuring Justin Bieber
Locked Out Of Heaven : Bruno Mars
Lonely Boy : The Black Keys
Lotus Flower Bomb : Wale Featuring Miguel
Loud : Mac Miller
Love And War : Tamar Braxton
Love Sosa : Chief Keef
Love This Life : T.I.
Love You Like A Love Song : Selena Gomez & The Scene
Love's Gonna Make It Alright : George Strait
Lovin' You Is Fun : Easton Corbin
Madness : Muse
Magic : Future Featuring T.I.
Make Me Proud : Drake Featuring Nicki Minaj
Marry The Night : Lady Gaga
Mercy : Dave Matthews Band
Mercy : Kanye West, Big Sean, Pusha T, 2 Chainz
Merry Go 'Round : Kacey Musgraves
Midnight City : M83.
Mirror : Lil Wayne Featuring Bruno Mars
Moves Like Jagger : Maroon 5 Featuring Christina Aguilera
Mr. Wrong : Mary J. Blige Featuring Drake
Mutha***** Up : Tyga Featuring Nicki Minaj
My Homies Still : Lil Wayne Featuring Big Sean
My Life : 50 Cent Featuring Eminem & Adam Levine
My Moment : DJ Drama, 2 Chainz, Meek Mill, Jeremih
Naked : Dev & Enrique Iglesias
New Day : 50 Cent Featuring Dr. Dre & Alicia Keys
New God Flow : Pusha T Kanye West
Ni**as in Paris : Jay Z Kanye West
No Church In The Wild : Jay Z Kanye West Featuring Frank Ocean
No Hurry : Zac Brown Band
No Lie : 2 Chainz Featuring Drake
No Worries : Lil Wayne Featuring Detail
Nobody's Perfect : J. Cole Featuring Missy Elliott
Not Over You : Gavin DeGraw
Nothing : The Script
Oath : Cher Lloyd Featuring Becky G
Oh Love : Green Day
One More Night : Maroon 5
Over You : Miranda Lambert
Paradise : Coldplay
Part Of Me : Katy Perry
Party : Beyonce Featuring Andre 3000
Party Rock Anthem : LMFAO Featuring Lauren Bennett & GoonRock
Payphone : Maroon 5 Featuring Wiz Khalifa
Play The Guitar : B.o.B Featuring Andre 3000
Poetic Justice : Kendrick Lamar Featuring Drake
Pontoon : Little Big Town
Pop That : French Montana Featuring Rick Ross, Drake, Lil Wayne
Princess Of China : Coldplay Featuring Rihanna
Promises : Nero
Put It Down : Brandy Featuring Chris Brown
Rack City : Tyga
Raise Your Weapon : deadmau5 Featuring Greta Svabo Bech
Ready Or Not : Bridgit Mendler
Remember You : Wiz Khalifa Featuring The Weeknd
Representin' : Ludacris Featuring Kelly Rowland
Rest Of My Life : Ludacris Featuring Usher & David Guetta
Right By My Side : Nicki Minaj Featuring Chris Brown
Right Here : Justin Bieber Featuring Drake
Roman Reloaded : Nicki Minaj Featuring Lil Wayne
Round Of Applause : Waka Flocka Flame Featuring Drake
Roxanne : Juliet Simms
Rumour Has It : Adele
Runaways : The Killers
Safe & Sound : Taylor Swift Featuring The Civil Wars
Sail : AWOLNATION
Say Aah : Lindsey Pavao
Scary Monsters And Nice Sprites : Skrillex
Scream & Shout : will.i.am Featuring Britney Spears
Set You Free : 3OH!3
Settle Down : No Doubt
Sexy And I Know It : Glee Cast Featuring Ricky Martin
Sexy And I Know It : LMFAO
Shadow Days : John Mayer
Shake It Out : Florence + The Machine
She Doesn't Mind : Sean Paul
She Will : Lil Wayne Featuring Drake
She's So Mean : matchbox twenty
Shinin' On Me : Jerrod Niemann
Smooth Criminal : Glee Cast Featuring 2Cellos
Snap Backs & Tattoos : Driicky Graham
Snitches Ain't... : YG Featuring Tyga, Snoopd Dogg & Nipsey Hussle
So Good : B.o.B
Some Nights : fun.
Somebody That I Used To Know : Gotye Featuring Kimbra
Somethin' 'Bout A Truck : Kip Moore
Something To Do With My Hands : Thomas Rhett
Somewhere Over The Rainbow : Nicholas David
Southern Comfort Zone : Brad Paisley
Springsteen : Eric Church
Stars : Amanda Brown
Stars : Grace Potter & The Nocturnals
Starships : Nicki Minaj
Stay Schemin : Rick Ross Featuring Drake & French Montana
Stereo Hearts : Gym Class Heroes Featuring Adam Levine
Strange Clouds : B.o.B Featuring Lil Wayne
Strip : Chris Brown Featuring Kevin K-MAC McCall
Strip : Chris Brown Featuring Kevin McCall
Stronger (What Doesn't Kill You) : Kelly Clarkson
Stupid Boy : Cassadee Pope
Sweet Nothing : Calvin Harris Featuring Florence Welch
Swimming Pools (Drank) : Kendrick Lamar
T.H.E (The Hardest Ever) : will.i.am Featuring Mick Jagger & Jennifer Lopez
TTYLXOX : Bella Thorne
Take A Walk : Passion Pit
Take Care : Drake Featuring Rihanna
Take It To The Head : DJ Khaled Featuring Chris Brown, Rick Ross, Nicki Minaj & Lil Wayne
Talk That Talk : Rihanna Featuring Jay-Z
Tattoo : Van Halen
Thank You : Estelle
That Way : Wale Featuring Jeremih & Rick Ross
That's Why I Pray : Big & Rich
The A Team : Ed Sheeran
The Champ : Nelly
The Fighter : Gym Class Heroes Featuring Ryan Tedder
The Motto : Drake Featuring Lil Wayne
The One That Got Away : Jake Owen
The Only Way I Know : Jason Aldean With Luke Bryan & Eric Church
The Prayer : Christina Aguilera & Chris Mann
The Trouble With Girls : Scotty McCreery
Think Like A Man : Jennifer Hudson & Ne-Yo Featuring Rick Ross
Thinkin Bout You : Frank Ocean
This Ole Boy : Craig Morgan
Thrift Shop : Macklemore & Ryan Lewis Featuring Wanz
Throw That : Slaughterhouse Featuring Eminem
Til My Last Day : Justin Moore
Time Is Love : Josh Turner
Titanium : David Guetta Featuring Sia
To The World : Kanye West, R. Kelly
Tongue Tied : Grouplove
Tonight (Best You Ever Had) : John Legend Featuring Ludacris
Tonight Is The Night : Outasight
Too Close : Alex Clare
Too Close : Melanie Martinez
Turn Me On : David Guetta Featuring Nicki Minaj
Turn On The Lights : Future
Turn Up The Music : Chris Brown
UP! : LoveRance Featuring IamSu & Skipper or 50 Cent
Video Games : Lana Del Rey
Want U Back : Cher Lloyd
Wanted : Hunter Hayes
Way Too Cold : Kanye West Featuring DJ Khaled
We Are Young : fun. Featuring Janelle Monae
We Found Love : Rihanna Featuring Calvin Harris
We Run The Night : Havana Brown Featuring Pitbull
What Makes You Beautiful : One Direction
When We Stand Together : Nickelback
Where Have You Been : Rihanna
Where I Come From : Montgomery Gentry
Who Booty : Jonn Hart Featuring iamSU
Why Ya Wanna : Jana Kramer
Wicked Games : The Weeknd
Wild Boy : MGK Featuring Waka Flocka Flame
Wild Ones : Flo Rida Featuring Sia
Windows Down : BTR
Wish You Were Here : Avril Lavigne
Without You : David Guetta Featuring Usher
Wobble Baby Wobble : V.I.C.
Work Hard, Play Hard : Wiz Khalifa
Work Out : J. Cole
Yesterday : Adam Levine & Tony Lucca
You : Chris Young
You Don't Know Her Like I Do : Brantley Gilbert
You Make Me Feel... : Cobra Starship Featuring Sabi
You The Boss : Rick Ross Featuring Nicki Minaj
Young & Gettin' It : Meek Mill Featuring Kirko Bangz
Young, Wild & Free : Snoop Dogg & Wiz Khalifa Featuring Bruno Mars
Your Body : Christina Aguilera
Yuck! : 2 Chainz Featuring Lil Wayne
m.A.A.d City : Kendrick Lamar Featuring MC Eiht
