#SELFIE : The Chainsmokers
***Flawless : Beyonce Featuring Nicki Minaj Or Chimamanda Ngozi Adichie
0 To 100 / The Catch Up : Drake
19 You + Me : Dan + Shay
2 On : Tinashe Featuring ScHoolboy Q
23 : Mike WiLL Made-It Featuring Miley Cyrus, Wiz Khalifa & Juicy J
24 Hours : TeeFLii Featuring 2 Chainz
A Sky Full Of Stars : Coldplay
About The Money : T.I. Featuring Young Thug
Achy Breaky 2 : Buck 22 Featuring Billy Ray Cyrus
Adrenalina : Wisin Featuring Jennifer Lopez & Ricky Martin
Ain't It Fun : Paramore
All About That Bass : Meghan Trainor
All Me : Drake Featuring 2 Chainz & Big Sean
All Of Me : John Legend
All That Matters : Justin Bieber
Am I Wrong : Nico & Vinz
American Kids : Kenny Chesney
Angel In Blue Jeans : Train
Animals : Martin Garrix
Applause : Lady Gaga
Automatic : Miranda Lambert
Baby Don't Lie : Gwen Stefani
Baby It's Cold Outside : Idina Menzel Duet With Michael Buble
Bailando : Enrique Iglesias Featuring Descemer Bueno & Gente de Zona
Bang Bang : Jessie J, Ariana Grande & Nicki Minaj
Bartender : Lady Antebellum
Beachin' : Jake Owen
Beat Of The Music : Brett Eldredge
Bed Of Lies : Nicki Minaj Featruing Skylar Grey
Beg For It : Iggy Azalea Featuring M0
Believe Me : Lil Wayne Featuring Drake
Bend Ova : Lil Jon Featuring Tyga
Best Day Of My Life : American Authors
Best Mistake : Ariana Grande Featuring Big Sean
Birthday : Katy Perry
Black Widow : Iggy Azalea Featuring Rita Ora
Blame : Calvin Harris Featuring John Newman
Blurred Lines : Robin Thicke Featuring T.I. + Pharrell
Bo$$ : Fifth Harmony
Body Language : Kid Ink Featuring Usher & Tinashe
Boom Clap : Charli XCX
Booty : Jennifer Lopez Featuring Iggy Azalea Or Pitbull
Bottoms Up : Brantley Gilbert
Bounce It : Juicy J Featuring Wale & Trey Songz
Bound 2 : Kanye West
Brave : Sara Bareilles
Break Free : Ariana Grande Featuring Zedd
Burn : Ellie Goulding
Burnin' It Down : Jason Aldean
Burnin' Up : Jessie J Featuring 2 Chainz
Calm Down : Busta Rhymes Featuring Eminem
Can't Raise A Man : K. Michelle
Can't Remember To Forget You : Shakira Featuring Rihanna
Centuries : Fall Out Boy
Chainsaw : The Band Perry
Chandelier : Sia
Chasing The Sun : Hilary Duff
Chocolate : The 1975
Classic : MKTO
Close Your Eyes : Parmalee
CoCo : O.T. Genasis
Collard Greens : ScHoolboy Q Featuring Kendrick Lamar
Come Get It Bae : Pharrell
Come Join The Murder : The White Buffalo & The Forest Rangers
Come With Me Now : KONGOS
Confident : Justin Bieber Featuring Chance The Rapper
Cool Kids : Echosmith
Cop Car : Keith Urban
Cut Her Off : KCamp Featuring 2 Chainz
Dangerous : David Guetta Featuring Sam Martin
Dare (La La La) : Shakira
Dark Horse : Katy Perry Featuring Juicy J
Day Drinking : Little Big Town
Delirious (Boneless) : Steve Aoki, Chris Lake & Tujamo Featuring Kid Ink
Demons : Imagine Dragons
Dirt : Florida Georgia Line
Do I Wanna Know? : Arctic Monkeys
Do They Know It's Christmas? (2014) : Band Aid 30
Do What U Want : Lady Gaga Featuring R. Kelly
Do You Want To Build A Snowman? : Kristen Bell, Agatha Lee Monn & Katie Lopez
Doin' What She Likes : Blake Shelton
Don't Tell 'Em : Jeremih Featuring YG
Drink To That All Night : Jerrod Niemann
Drunk In Love : Beyonce Featuring Jay Z
Drunk In Love : Beyonce Featuring Jay-Z
Drunk On A Plane : Dierks Bentley
Dust : Eli Young Band
EW! : Jimmy Fallon Featuring will.i.am
El Perdedor : Enrique Iglesias Featuring Marco Antonio Solis
Errrbody : Yo Gotti
Everybody's Got Somebody But Me : Hunter Hayes Featuring Jason Mraz
Everything I Shouldn't Be Thinking About : Thompson Square
Everything Is AWESOME!!! : Tegan And Sara Featuring The Lonely Island
Fancy : Iggy Azalea Featuring Charli XCX
Feelin' Myself : will.i.am Featuring Miley Cyrus, French Montana, Wiz Khalifa & DJ Mustard
Fever : The Black Keys
Fight Night : Migos
Fireball : Pitbull Featuring John Ryan
First Love : Jennifer Lopez
Follow Your Arrow : Kacey Musgraves
For The First Time In Forever : Kristen Bell & Idina Menzel
G.D.F.R. : Flo Rida Featuring Sage The Gemini & Lookas
Gas Pedal : Sage The Gemini Featuring IamSu!
Geronimo : Sheppard
Get Her Back : Robin Thicke
Get Me Some Of That : Thomas Rhett
Ghost : Ella Henderson
Girl In A Country Song : Maddie & Tae
Girls Chase Boys : Ingrid Michaelson
Give Me Back My Hometown : Eric Church
God Made Girls : RaeLynn
Good Kisser : Usher
Goodnight Kiss : Randy Houser
Guts Over Fear : Eminem Featuring Sia
Habits (Stay High) : Tove Lo
Hangover : PSY Featuring Snoop Dogg
Happy : Pharrell Williams
Happy Little Pill : Troye Sivan
HeadBand : B.o.B Featuring 2 Chainz
Headlights : Eminem Featuring Nate Ruess
Heart Attack : Enrique Iglesias
Heaven : Jake Worthington
Hello Kitty : Avril Lavigne
Heroes (We Could Be) : Alesso Featuring Tove Lo
Hey Brother : Avicii
Hideaway : Kiesza
Hold On, We're Going Home : Drake Featuring Majid Jordan
Hold You Down : DJ Khaled Featuring Chris Brown, August Alsina, Future & Jeremih
Hold You Down : DJ Khaled Featuring Chris Brown, August Alsina, Future, & Jeremih
Holy Grail : Jay Z Featuring Justin Timberlake
Homegrown Honey : Darius Rucker
Honest : Future
Hookah : Tyga Featuring Young Thug
Hope You Get Lonely Tonight : Cole Swindell
Hot Boy : Bobby Shmurda
How I Feel : Flo Rida
How To Love : Christina Grimmie
Human : Christina Perri
I Can't Make You Love Me : Josh Kaufman
I Don't Dance : Lee Brice
I Don't F**k With You : Big Sean Featuring E-40
I Don't Mind : Usher Featuring Juicy J
I Got A Car : George Strait
I Have Nothing : Tessanne Chin
I Luh Ya Papi : Jennifer Lopez Featuring French Montana
I Luv This Sh*t : August Alsina Featuring Trinidad James
I Will Never Let You Down : Rita Ora
I Won : Future Featuring Kanye West
I Won't Let You Down : OK Go
I'm Not Gonna Miss You : Glen Campbell
I'm Ready : AJR
Invisible : Hunter Hayes
It Won't Stop : Sevyn Streeter Featuring Chris Brown
Jealous : Nick Jonas
John Doe : B.o.B Featuring Priscilla
Jungle : Jamie N Commons & X Ambassadors
Keep Them Kisses Comin' : Craig Campbell
L.A.LOVE (la la) : Fergie
La La La : Naughty Boy Featuring Sam Smith
Latch : Disclosure Featuring Sam Smith
Later On : The Swon Brothers
Leave The Night On : Sam Hunt
Left Hand Free : alt-J
Let Her Go : Passenger
Let It Be : Tessanne Chin & Adam Levine
Let It Go : Idina Menzel
Lettin' The Night Roll : Justin Moore
Life Of The Party : Shawn Mendes
Lifestyle : Rich Gang Featuring Young Thug & Rich Homie Quan
Lolly : Maejor Ali Featuring Juicy J & Justin Bieber
Lonely Tonight : Blake Shelton Featuring Ashley Monroe
Look At You : Big & Rich
Lookin' For That Girl : Tim McGraw
Love Don't Die : The Fray
Love Is An Open Door : Kristen Bell & Santino Fontana
Love Me Again : John Newman
Love Me Harder : Ariana Grande & The Weeknd
Love More : Chris Brown Featuring Nicki Minaj
Love Never Felt So Good : Michael Jackson & Justin Timberlake
Love Runs Out : OneRepublic
Loyal : Chris Brown Featuring Lil Wayne & French Montana Or & Too $hort
Loyal : Chris Brown Featuring Lil Wayne & French Montana Or Too $hort
Loyal : Chris Brown Featuring Lil Wayne & French Montana Or Too $hort Or Tyga
Made Me : Snootie Wild Featuring K Camp
Main Chick : Kid Ink Featuring Chris Brown
Man Of The Year : ScHoolboy Q
Maps : Maroon 5
Mary, Did You Know? : Pentatonix
Me And My Broken Heart : Rixton
Meanwhile Back At Mama's : Tim McGraw Featuring Faith Hill
Mine : Beyonce Featuring Drake
Mmm Yeah : Austin Mahone Featuring Pitbull
Move That Doh : Future Featuring Pharrell, Pusha T & Casino
My Eyes : Blake Shelton Featuring Gwen Sebastian
My Hitta : YG Featuring Jeezy & Rich Homie Quan
Na Na : Trey Songz
Neon Lights : Demi Lovato
New Flame : Chris Brown Featuring Usher & Rick Ross
No Flex Zone : Rae Sremmurd
No Love : August Alsina
No Mediocre : T.I. Featuring Iggy Azalea
Not A Bad Thing : Justin Timberlake
Oceans (Where Feet May Fail) : Hillsong UNITED
Odio : Romeo Santos Featuring Drake
Often : The Weeknd
Old School Love : Lupe Fiasco Featuring Ed Sheeran
Only : Nicki Minaj Featuring Drake, Lil Wayne & Chris Brown
Or Nah : Ty Dolla $ign Featuring Wiz Khalifa & DJ Mustard
Ordinary Love : U2
Outside : Calvin Harris Featuring Ellie Goulding
Paranoid : Ty Dolla $ign Featuring B.o.B
Part II (On The Run) : Jay Z Featuring Beyonce
Partition : Beyonce
Perfume : Britney Spears
Pills N Potions : Nicki Minaj
Play It Again : Luke Bryan
Pompeii : Bastille
Prayer In C : Lillywood & Robin Schulz
Problem : Ariana Grande Featuring Iggy Azalea
Raging Fire : Phillip Phillips
Rap God : Eminem
Rather Be : Clean Bandit Featuring Jess Glynne
Ready Set Roll : Chase Rice
Really Don't Care : Demi Lovato Featuring Cher Lloyd
Red Lights : Tiesto
Replay : Zendaya
Rewind : Rascal Flatts
Ride : SoMo
Riptide : Vance Joy
River Bank : Brad Paisley
Rockin' Around The Christmas Tree : Brenda Lee
Royals : Taylor John Williams
Rude : MAGIC!
Safe And Sound : Capital Cities
Sail : AWOLNATION
Sanctified : Rick Ross Featuring Kanye West & Big Sean
Santa Tell Me : Ariana Grande
Say Something : A Great Big World & Christina Aguilera
Secrets : Mary Lambert
See You Tonight : Scotty McCreery
Seen It All : Jeezy Featuring Jay Z
Shake It Off : Taylor Swift
She Came To Give It To You : Usher Featuring Nicki Minaj
She Knows : J. Cole Featuring Amber Coffman & The Cults
She Knows : Ne-Yo Featuring Juicy J
She Looks So Perfect : 5 Seconds Of Summer
She Twerkin : Ca$h Out
Shell Shocked : Juicy J, Wiz Khalifa & Ty Dolla $ign Featuring Kill The Noise & Madsonik
Shower : Becky G
Shut Up + Dance : Walk The Moon
Sing : Ed Sheeran
Sleeping With A Friend : Neon Trees
Slow Me Down : Sara Evans
Small Town Throwdown : Brantley Gilbert Featuring Justin Moore & Thomas Rhett
Somebody That I Used To Know : Christina Grimmie & Adam Levine
Somethin' Bad : Miranda Lambert Duet With Carrie Underwood
Something In The Water : Carrie Underwood
Song About A Girl : Eric Paslay
Stay The Night : Zedd Featuring Hayley Williams
Stay With Me : Sam Smith
Stolen Dance : Milky Chance
Stoner : Young Thug
Story Of My Life : One Direction
Studio : ScHoolboy Q Featuring BJ The Chicago Kid
Summer : Calvin Harris
Sunshine & Whiskey : Frankie Ballard
Superheroes : The Script
Sweater Weather : The Neighbourhood
Sweet Annie : Zac Brown Band
Take Me Home : Cash Cash Featuring Bebe Rexha
Take Me To Church : Hozier
Talk Dirty : Jason Derulo Featuring 2 Chainz
Ten Feet Tall : Afrojack Featuring Wrabel
Tennis Court : Lorde
The Big Bang : Katy Tiz
The Blower's Daughter : Matt McAndrew
The Christmas Song (Merry Christmas To You) : Nat King Cole
The Devil Is A Lie : Rick Ross Featuring JAY Z
The Fox : Ylvis
The Hanging Tree : James Newton Howard Featuring Jennifer Lawrence
The Heart Of Dixie : Danielle Bradbery
The Heart Wants What It Wants : Selena Gomez
The Man : Aloe Blacc
The Monster : Eminem Featuring Rihanna
The Old Rugged Cross : Craig Wayne Boyd
The Walker : Fitz And The Tantrums
The Worst : Jhene Aiko
They Don't Know : Rico Love
Thinking About You : Calvin Harris Featuring Ayah Marar
This Is How We Roll : Florida Georgia Line Featuring Luke Bryan
This Is How We Roll : Florida Georgia Line Ft. Jason Derulo & Luke Bryan
Thriller : Michael Jackson
Timber : Pitbull Featuring Ke$ha
Time Of Our Lives : Pitbull & Ne-Yo
Touchin, Lovin : Trey Songz Featuring Nicki Minaj
Trophies : Young Money Featuring Drake
Trumpets : Jason Derulo
Try : Colbie Caillat
Try Me : DeJ Loaf
Tuesday : I LOVE MAKONNEN Featuring Drake
Turn Down For What : DJ Snake & Lil Jon
U Guessed It : OG Maco
U Guessed It : OG Maco Featuring 2 Chainz
Underneath The Tree : Kelly Clarkson
Up All Night : Jon Pardi
Up Down (Do This All Day) : T-Pain Featuring B.o.B
Uptown Funk! : Mark Ronson Featuring Bruno Mars
V. 3005 : Childish Gambino
Waiting For Superman : Daughtry
Wake Up Lovin' You : Craig Morgan
Walk Thru : Rich Homie Quan Featuring Problem
Wasted : Tiesto Featuring Matthew Koma
Wasting All These Tears : Cassadee Pope
Waves : Mr. Probz
We Are One (Ole Ola) [The 2014 FIFA World Cup Official Song] : Pitbull Featuring Jennifer Lopez & Claudia Leitte
We Are Tonight : Billy Currington
We Dem Boyz : Wiz Khalifa
We Might Be Dead By Tomorrow : Soko
We Were Us : Keith Urban And Miranda Lambert
West Coast : Lana Del Rey
Wet Dreamz : J. Cole
Whatever She's Got : David Nail
When I Was Your Man : Chris Jamison
Where It's At (Yep, Yep) : Dustin Lynch
Whiskey In My Water : Tyler Farr
White Walls : Macklemore & Ryan Lewis Featuring ScHoolboy Q & Hollis
Who Do You Love? : YG Featuring Drake
Who I Am With You : Chris Young
Who You Love : John Mayer Featuring Katy Perry
Wiggle : Jason Derulo Featuring Snoop Dogg
Wild Life : Jack & Jack
Wild Wild Love : Pitbull Featuring G.R.L.
Word Crimes : "Weird Al" Yankovic
Word Crimes : Weird Al Yankovic
Work : Iggy Azalea
Wrecking Ball : Miley Cyrus
X : Chris Brown
XO : John Mayer
Yeah : Joe Nichols
You And Your Friends : Wiz Khalifa Featuring Snoop Dogg & Ty Dolla $ign
You Sound Good To Me : Lucy Hale
You're Mine (Eternal) : Mariah Carey
Young Girls : Bruno Mars
i : Kendrick Lamar
m.A.A.d City : Kendrick Lamar Featuring MC Eiht
