$ave Dat Money : Lil Dicky Featuring Fetty Wap & Rich Homie Quan
***Flawless : Beyonce Featuring Nicki Minaj Or Chimamanda Ngozi Adichie
100 : The Game Featuring Drake
100 Grandkids : Mac Miller
3500 : Travi$ Scott Featuring Future & 2 Chainz
679 : Fetty Wap Featuring Remy Boyz
7/11 : Beyonce
A Guy Walks Into A Bar : Tyler Farr
About The Money : T.I. Featuring Young Thug
Adore : Cashmere Cat Featuring Ariana Grande
Adventure Of A Lifetime : Coldplay
Ain't Worth The Whiskey : Cole Swindell
All About It : Hoodie Allen Featuring Ed Sheeran
All Day : Kanye West Featuring Theophilus London, Allan Kingdom & Paul McCartney
All Eyes On You : Meek Mill Featuring Chris Brown & Nicki Minaj
All I Want For Christmas Is You : Mariah Carey
All Your Fault : Big Sean Featuring Kanye West
Alright : Kendrick Lamar
Anaconda : Nicki Minaj
Animals : Maroon 5
Antidote : Travi$ Scott
Apparently : J. Cole
Ayo : Chris Brown & Tyga
B**** Better Have My Money : Rihanna
B**** I'm Madonna : Madonna Featuring Nicki Minaj
Baby Be My Love Song : Easton Corbin
Baby Blue : Action Bronson Featuring Chance The Rapper
Back It Up : Prince Royce Featuring Jennifer Lopez & Pitbull
Back Up : DeJ Loaf Featuring Big Sean
Backroad Song : Granger Smith
Bad B*tch : French Montana Featuring Jeremih
Bad Blood : Taylor Swift Featuring Kendrick Lamar
Bad For You : Meek Mill Featuring Nicki Minaj
Bang Bang : Jessie J, Ariana Grande & Nicki Minaj
Be Real : Kid Ink Featuring DeJ Loaf
Beautiful Life : Nick Fradiani
Beautiful Now : Zedd Featuring Jon Bellion
Bed Of Lies : Nicki Minaj Featruing Skylar Grey
Bed Of Lies : Nicki Minaj Featuring Skylar Grey
Beg For It : Iggy Azalea Featuring M0
Believe : Mumford & Sons
Best Friend : Young Thug
Best Friends : Sophia Grace
Bet You Can't Do It Like Me : DLOW
Bills : LunchMoney Lewis
Black Magic : Little Mix
Black Widow : Iggy Azalea Featuring Rita Ora
Blame : Calvin Harris Featuring John Newman
Blank Space : I Prevail
Blank Space : Taylor Swift
Blase : Ty Dolla $ign Featuring Future & Rae Sremmurd
Blessings : Big Sean Featuring Drake
Body Language : Kid Ink Featuring Usher & Tinashe
Boyz-N-The Hood : Eazy-E
Break The Rules : Charli XCX
Break Up With Him : Old Dominion
Bright : Echosmith
Brother : NEEDTOBREATHE Featuring Gavin DeGraw
Budapest : George Ezra
Burn Slow : Wiz Khalifa Featuring Rae Sremmurd
Burnin' Up : Jessie J Featuring 2 Chainz
Burning House : Cam
Buy Me A Boat : Chris Janson
Cake By The Ocean : DNCE
Can't Stop Dancin' : Becky G
Cecilia And The Satellite : Andrew McMahon In The Wilderness
Centuries : Fall Out Boy
Chandelier : Sia
Change My Mind : Meghan Linsey
Cheerleader : OMI
Classic Man : Jidenna Featuring Roman GianArthur
Close Your Eyes : Parmalee
CoCo : O.T. Genasis
Coffee : Miguel
Comfortable : K Camp
Conqueror : Empire Cast Featuring Estelle & Jussie Smollett
Cool For The Summer : Demi Lovato
Daddy : PSY Featuring CL
Dangerous : David Guetta Featuring Sam Martin
Dark Times : The Weeknd Featuring Ed Sheeran
Dessert : Dawin
Diamond Rings And Old Barstools : Tim McGraw With Catherine Dunn
Dibs : Kelsea Ballerini
Do It Again : Pia Mia Featuring Chris Brown & Tyga
Don't : Bryson Tiller
Don't It : Billy Currington
Don't Tell 'Em : Jeremih Featuring YG
Down In The DM : Yo Gotti
Downtown : Macklemore & Ryan Lewis Featuring Eric Nally, Melle Mel, Kool Moe Dee & Grandmaster Caz
Drifting : G-Eazy Featuring Chris Brown & Tory Lanez
Drinking Class : Lee Brice
El Perdon (Forgiveness) : Nicky Jam & Enrique Iglesias
Electric Body : A$AP Rocky Featuring ScHoolboy Q
Everyday : A$AP Rocky Featuring Rod Stewart x Miguel x Mark Ronson
Ex's & Oh's : Elle King
Failure : Breaking Benjamin
Feeling Myself : Nicki Minaj Featuring Beyonce
Fight Song : Rachel Platten
Fire N Gold : Bea Miller
Fireball : Pitbull Featuring John Ryan
Firestone : Kygo Featuring Conrad
First Kiss : Kid Rock
Flex (Ooh Ooh Ooh) : Rich Homie Quan
Flicka Da Wrist : Chedda Da Connect
FourFiveSeconds : Rihanna & Kanye West & Paul McCartney
Fun : Pitbull Featuring Chris Brown
G.D.F.R. : Flo Rida Featuring Sage The Gemini & Lookas
Geronimo : Sheppard
Get Low : Dillon Francis & DJ Snake
Get On Your Knees : Nicki Minaj Featuring Ariana Grande
Ghost : Ella Henderson
Ghost Town : Adam Lambert
Ginza : J Balvin
Girl Crush : Little Big Town
Girl In A Country Song : Maddie & Tae
Girls Just Want To Have Fun : Madi Davis
Glory : Common & John Legend
Go Hard Or Go Home : Wiz Khalifa & Iggy Azalea
God Made Girls : RaeLynn
Gonna : Blake Shelton
Gonna Wanna Tonight : Chase Rice
Good For You : Selena Gomez Featuring A$AP Rocky
Good Lovin : Ludacris Featuring Miguel
Good Thing : Sage The Gemini Featuring Nick Jonas
Goodbye : Who Is Fancy
Habits (Stay High) : Tove Lo
Hallelujah : Panic! At The Disco
Heartbeat Song : Kelly Clarkson
Hell Of A Night : Dustin Lynch
Hello : Adele
Here : Alessia Cara
Heroes (We Could Be) : Alesso Featuring Tove Lo
Hey Mama : David Guetta Featuring Nicki Minaj & Afrojack
Hey Mama : David Guetta Featuring Nicki Minaj, Bebe Rexha & Afrojack
Hide Away : Daya
High By The Beach : Lana Del Rey
Hit The Quan : @iHeartMemphis
Hit The Quan : iHeartMemphis
Hit The Quan : iLoveMemphis
Hold Each Other : A Great Big World Featuring FUTURISTIC
Hold My Hand : Jess Glynne
Hold You Down : DJ Khaled Featuring Chris Brown, August Alsina, Future & Jeremih
Home Alone Tonight : Luke Bryan Featuring Karen Fairchild
Homegrown : Zac Brown Band
Homegrown Honey : Darius Rucker
Honey, I'm Good. : Andy Grammer
Hood Go Crazy : Tech N9Ne Featuring 2 Chainz & B.o.B
Hot Boy : Bobby Shmurda
Hotel : Kid Ink Featuring Chris Brown
Hotline Bling : Drake
House Of The Rising Sun : Kimberly Nichole
How Deep Is Your Love : Calvin Harris & Disciples
How Many Times : DJ Khaled Featuring Chris Brown, Lil Wayne & Big Sean
I Bet : Ciara
I Bet My Life : Imagine Dragons
I Don't F**k With You : Big Sean Featuring E-40
I Don't Get Tired (#IDGT) : Kevin Gates Featuring August Alsina
I Don't Like It, I Love It : Flo Rida Featuring Robin Thicke & Verdine White
I Don't Mind : Usher Featuring Juicy J
I Got The Boy : Jana Kramer
I Know What You Did Last Summer : Shawn Mendes & Camila Cabello
I Lived : OneRepublic
I Love This Life : LoCash
I Mean It : G-Eazy Featuring Remo
I Need Your Love : Shaggy Featuring Mohombi, Faydee, Costi
I Put A Spell On You : Annie Lennox
I Really Like You : Carly Rae Jepsen
I See You : Luke Bryan
I Want You To Know : Zedd Featuring Selena Gomez
I'd Just Love To Lay You Down : Barrett Baber
I'm Not The Only One : Sam Smith
I'm To Blame : Kip Moore
If Only : Dove Cameron
In Your Arms : Nico & Vinz
Institutionalized : Kendrick Lamar Featuring Bilal, Anna Wise & Snoop Dogg
Jealous : Nick Jonas
Jump Out The Face : Meek Mill Featuring Future
Jumpman : Drake & Future
Just Gettin' Started : Jason Aldean
Keep Your Money : Empire Cast Featuring Jussie Smollett
Kings Never Die : Eminem Featuring Gwen Stefani
Kiss You In The Morning : Michael Ray
L$D : A$AP Rocky
L.A.LOVE (la la) : Fergie
Lay It All On Me : Rudimental Featuring Ed Sheeran
Lean On : Major Lazer & DJ Snake Featuring M0
Lean On : Major Lazer X DJ Snake Featuring M0
Lifestyle : Rich Gang Featuring Young Thug & Rich Homie Quan
Like A Cowboy : Randy Houser
Like I'm Gonna Lose You : Meghan Trainor Featuring John Legend
Lips Are Movin : Meghan Trainor
Liquor : Chris Brown
Little Red Wagon : Miranda Lambert
Locked Away : R. City Featuring Adam Levine
Lonely Eyes : Chris Young
Lonely Tonight : Blake Shelton Featuring Ashley Monroe
Lord Knows : Meek Mill
Losers : The Weeknd Featuring Labrinth
Lost Stars : Matt McAndrew & Adam Levine
Lost Without U : Chris Jamison & Adam Levine
Love Is Your Name : Steven Tyler
Love Me : The 1975
Love Me Harder : Ariana Grande & The Weeknd
Love Me Like You Do : Ellie Goulding
Love Myself : Hailee Steinfeld
Love You Like That : Canaan Smith
Make It Rain : Koryn Hawthorne
Make Me Wanna : Thomas Rhett
Marvin Gaye : Charlie Puth Featuring Meghan Trainor
Mary, Did You Know? : Pentatonix
Masterpiece : Jessie J
Me, Myself & I : G-Eazy x Bebe Rexha
Mean To Me : Brett Eldredge
My Baby's Got A Smile On Her Face : Craig Wayne Boyd
My House : Flo Rida
My Way : Fetty Wap Featuring Monty
Nasty : Bandit Gang Marco Featuring Dro
Nasty Freestyle : T-Wayne
New Americana : Halsey
Night Changes : One Direction
No Love : August Alsina
No Pressure : Justin Bieber Featuring Big Sean
No Sense : Justin Bieber Featuring Travi$ Scott
No Sleeep : Janet
No Sleeep : Janet Featuring J. Cole
No Type : Rae Sremmurd
Nobody Love : Tori Kelly
Not For Long : B.o.B Featuring Trey Songz
Nothin' Like You : Dan + Shay
Nothing But Trouble (Instagram Models) : Lil Wayne & Charlie Puth
Nothing Without Love : Nate Ruess
Often : The Weeknd
Omen : Disclosure Featuring Sam Smith
One Call Away : Charlie Puth
One Hell Of An Amen : Brantley Gilbert
One Man Can Change The World : Big Sean Featuring Kanye West & John Legend
Only : Nicki Minaj Featuring Drake, Lil Wayne & Chris Brown
Only One : Kanye West Featuring Paul McCartney
Out The Speakers : A-Trak + Milo & Otis Featuring Rich Kidz
Outside : Calvin Harris Featuring Ellie Goulding
Paradise : Big Sean
Perfect Storm : Brad Paisley
Phenomenal : Eminem
Planes : Jeremih Featuring J. Cole
Play No Games : Big Sean Featuring Chris Brown & Ty Dolla $ign
Post To Be : Omarion Featuring Chris Brown & Jhene Aiko
Powerful : Major Lazer Featuring Ellie Goulding & Tarrus Riley
Prayer In C : Lillywood & Robin Schulz
Preach : Drake Featuring PARTYNEXTDOOR
Pretty Girls : Britney Spears & Iggy Azalea
Prisoner : The Weeknd Featuring Lana Del Rey
R.I.C.O. : Meek Mill Featuring Drake
Raise 'Em Up : Keith Urban Featuring Eric Church
Random : G-Eazy
Rather Be : Clean Bandit Featuring Jess Glynne
Renegades : X Ambassadors
Rich $ex : Future
Ride Out : Kid Ink, Tyga, Wale, YG & Rich Homie Quan
Riptide : Vance Joy
Rockin' Around The Christmas Tree : Brenda Lee
Roses : The Chainsmokers Featuring ROZES
Rotten To The Core : Dove Cameron, Cameron Boyce, Booboo Stewart & Sofia Carson
Rude : MAGIC!
Runnin' (Lose It All) : Naughty Boy Featuring Beyonce & Arrow Benjamin
Santa Tell Me : Ariana Grande
Say It : Tory Lanez
Say You Do : Dierks Bentley
See You Again : Wiz Khalifa Featuring Charlie Puth
She Don't Love You : Eric Paslay
She Knows : Ne-Yo Featuring Juicy J
She's Kinda Hot : 5 Seconds Of Summer
Shell Shocked : Juicy J, Wiz Khalifa & Ty Dolla $ign Featuring Kill The Noise & Madsonik
Shotgun Rider : Tim McGraw
Shut Up And Dance : WALK THE MOON
Simple Man : Sawyer Fredericks
Sledgehammer : Fifth Harmony
Slow Motion : Trey Songz
Smoke : A Thousand Horses
Soldier : Damien
Somebody : Natalie La Rose Featuring Jeremih
Somebody To Love : Jordan Smith
Something In The Water : Carrie Underwood
Somewhere In My Car : Keith Urban
Sorry : Rick Ross Featuring Chris Brown
Sparks : Hilary Duff
Stay A Little Longer : Brothers Osborne
Stitches : Shawn Mendes
Stolen Dance : Milky Chance
Straight Outta Compton : N.W.A
Stressed Out : twenty one pilots
Stuck On A Feeling : Prince Royce Featuring Snoop Dogg
Sun Daze : Florida Georgia Line
Take It On Back : Chase Bryant
Take Me To Church : Hozier
Take Your Time : Sam Hunt
Talladega : Eric Church
Tennessee Whiskey : Chris Stapleton
The Body : Wale Featuring Jeremih
The Feeling : Justin Bieber Featuring Halsey
The Fix : Nelly Featuring Jeremih
The Hanging Tree : James Newton Howard Featuring Jennifer Lawrence
The Heart Wants What It Wants : Selena Gomez
The Matrimony : Wale Featuring Usher
These Walls : Kendrick Lamar Featuring Bilal. Anna Wise & Thundercat
Thinking Out Loud : Ed Sheeran
Thriller : Michael Jackson
Throw Sum Mo : Rae Sremmurd Featuring Nicki Minaj & Young Thug
Til It's Gone : Kenny Chesney
Time Of Our Lives : Pitbull & Ne-Yo
Touchin, Lovin : Trey Songz Featuring Nicki Minaj
Trap Queen : Fetty Wap
Trouble : Iggy Azalea Featuring Jennifer Hudson
Truffle Butter : Nicki Minaj Featuring Drake & Lil Wayne
Trumpets : Jason Derulo
Try : Colbie Caillat
Try Me : DeJ Loaf
Tuesday : I LOVE MAKONNEN Featuring Drake
Ulay Oh : How I Became The Bomb
Uptown Funk! : Mark Ronson Featuring Bruno Mars
Used To : Drake Featuring Lil Wayne
Used To Love You : Gwen Stefani
Used To Love You Sober : Kane Brown
Velvet : Chris Jamison
WTF (Where They From) : Missy Elliott Featuring Pharrell Williams
Wasted Love : Matt McAndrew
Watch Me : Silento
Waves : Mr. Probz
We Are : Justin Bieber Featuring Nas
Wesley's Theory : Kendrick Lamar Featuring George Clinton & Thundercat
What Do You Mean? : Justin Bieber
What Kind Of Man : Florence + The Machine
What We Ain't Got : Jake Owen
Where Are U Now : Skrillex & Diplo Featuring Justin Bieber
Where Are U Now : Skrillex & Diplo With Justin Bieber
Where Ya At : Future Featuring Drake
White Iverson : Post Malone
Wild Child : Kenny Chesney With Grace Potter
Work It : Missy "Misdemeanor" Elliott
Worth It : Fifth Harmony Featuring Kid Ink
Yellow Flicker Beat : Lorde
Yoga : Janelle Monae & Jidenna
You Changed Me : Jamie Foxx Featuring Chris Brown
You Know You Like It : DJ Snake & AlunaGeorge
You're So Beautiful : Empire Cast Featuring Jussie Smollett & Yazz
Young & Crazy : Frankie Ballard
