$ave Dat Money : Lil Dicky Featuring Fetty Wap & Rich Homie Quan
2 Phones : Kevin Gates
679 : Fetty Wap Featuring Remy Boyz
Adventure Of A Lifetime : Coldplay
All I Want For Christmas Is You : Mariah Carey
Antidote : Travi$ Scott
Back To Sleep : Chris Brown
Back Up : DeJ Loaf Featuring Big Sean
Backroad Song : Granger Smith
Bang My Head : David Guetta Featuring Sia & Fetty Wap
Beautiful Drug : Zac Brown Band
Best Friend : Young Thug
Bet You Can't Do It Like Me : DLOW
Blase : Ty Dolla $ign Featuring Future & Rae Sremmurd
Break On Me. : Keith Urban
Break Up In A Small Town : Sam Hunt
Burning House : Cam
Burning House : Emily Ann Roberts
Cake By The Ocean : DNCE
Cheerleader : OMI
Come Get Her : Rae Sremmurd
Confession : Florida Georgia Line
Confident : Demi Lovato
Dessert : Dawin
Dibs : Kelsea Ballerini
Die A Happy Man : Thomas Rhett
Don't : Bryson Tiller
Down In The DM : Yo Gotti
Downtown : Macklemore & Ryan Lewis Featuring Eric Nally, Melle Mel, Kool Moe Dee & Grandmaster Caz
Drunk On Your Love : Brett Eldredge
Ex's & Oh's : Elle King
Focus : Ariana Grande
Get Ugly : Jason Derulo
Ginza : J Balvin
God Only Knows : Jordan Smith & Adam Levine
Gonna : Blake Shelton
Gonna Know We Were Here : Jason Aldean
Good For You : Selena Gomez Featuring A$AP Rocky
Good To Be Alive (Hallelujah) : Andy Grammer
Hallelujah : Lindsey Stirling
Heartbeat : Carrie Underwood
Hello : Adele
Here : Alessia Cara
Hide Away : Daya
Hit The Quan : iLoveMemphis
Hollow : Tori Kelly
Home Alone Tonight : Luke Bryan Featuring Karen Fairchild
Hotline Bling : Drake
I Got The Boy : Jana Kramer
I Know What You Did Last Summer : Shawn Mendes & Camila Cabello
I Love This Life : LoCash
Irresistible : Fall Out Boy
Jingle Bell Rock : Bobby Helms
Jugg : Fetty Wap Featuring Monty
Jumpman : Drake & Future
Lay It All On Me : Rudimental Featuring Ed Sheeran
Lazarus : David Bowie
Lean On : Major Lazer & DJ Snake Featuring M0
Let It Go : James Bay
Like I'm Gonna Lose You : Meghan Trainor Featuring John Legend
Locked Away : R. City Featuring Adam Levine
Mary Did You Know : Jordan Smith
Me, Myself & I : G-Eazy x Bebe Rexha
Mr. Misunderstood : Eric Church
My House : Flo Rida
New Americana : Halsey
No Role Modelz : J. Cole
Nobody To Blame : Chris Stapleton
Nothin' Like You : Dan + Shay
On My Mind : Ellie Goulding
One Call Away : Charlie Puth
Perfect : One Direction
Play No Games : Big Sean Featuring Chris Brown & Ty Dolla $ign
Rockin' Around The Christmas Tree : Brenda Lee
Roses : The Chainsmokers Featuring ROZES
Same Old Love : Selena Gomez
Say It : Tory Lanez
See You Again : Wiz Khalifa Featuring Charlie Puth
Sorry : Justin Bieber
Stand By You : Rachel Platten
Stay A Little Longer : Brothers Osborne
Stick Talk : Future
Stitches : Shawn Mendes
Stressed Out : twenty one pilots
Strip It Down : Luke Bryan
Sugar : Robin Schulz Featuring Francesco Yates
The Christmas Song (Merry Christmas To You) : Nat King Cole
The Feeling : Justin Bieber Featuring Halsey
The Fix : Nelly Featuring Jeremih
The Hills : The Weeknd
Top Of The World : Tim McGraw
Trap Queen : Fetty Wap
Under Pressure : Queen & David Bowie
Used To Love You : Gwen Stefani
WTF (Where They From) : Missy Elliott Featuring Pharrell Williams
Watch Me : Silento
Watch Out : 2 Chainz
We Went : Randy Houser
Where Are U Now : Skrillex & Diplo With Justin Bieber
Where Ya At : Future Featuring Drake
White Iverson : Post Malone
Wildest Dreams : Taylor Swift
You Should Be Here : Cole Swindell
oui : Jeremih
