(Hey Won't You Play) Another Somebody Done Somebody Wrong Song : B.J. Thomas
Bad Blood : Neil Sedaka
Before The Next Teardrop Falls : Freddy Fender
Best Of My Love : Eagles
Black Water : The Doobie Brothers
Fallin' In Love : Hamilton, Joe Frank & Reynolds
Fame : David Bowie
Fire : Ohio Players
Fly, Robin, Fly : Silver Convention
Get Down Tonight : KC And The Sunshine Band
Have You Never Been Mellow : Olivia Newton-John
He Don't Love You (Like I Love You) : Tony Orlando & Dawn
I'm Sorry : John Denver
Island Girl : Elton John
Jive Talkin' : Bee Gees
Lady Marmalade : Labelle
Laughter In The Rain : Neil Sedaka
Let's Do It Again : The Staple Singers
Listen To What The Man Said : Wings
Love Will Keep Us Together : Captain & Tennille
Lovin' You : Minnie Riperton
Lucy In The Sky With Diamonds : Elton John
Mandy : Barry Manilow
My Eyes Adored You : Frankie Valli
One Of These Nights : Eagles
Philadelphia Freedom : The Elton John Band
Pick Up The Pieces : AWB
Please Mr. Postman : Carpenters
Rhinestone Cowboy : Glen Campbell
Shining Star : Earth, Wind & Fire
Sister Golden Hair : America
Thank God I'm A Country Boy : John Denver
That's The Way (I Like It) : KC And The Sunshine Band
The Hustle : Van McCoy The Soul City Symphony
You're No Good : Linda Ronstadt
