'03 Bonnie & Clyde : Jay-Z Featuring Beyonce Knowles
(There's Gotta Be) More To Life : Stacie Orrico
19 Somethin' : Mark Wills
21 Questions : 50 Cent Featuring Nate Dogg
4 Ever : Lil' Mo Featuring Fabolous
Act A Fool : Ludacris
Air Force Ones : Nelly Featuring Kyjuan, Ali & Murphy Lee
All I Have : Jennifer Lopez Featuring LL Cool J
All The Things She Said : t.A.T.u.
American Life : Madonna
Angel : Amanda Perez
Are You Happy Now? : Michelle Branch
Baby Boy : Beyonce Featuring Sean Paul
Beautiful : Christina Aguilera
Beautiful : Snoop Dogg Featuring Pharrell & Uncle Charlie Wilson
Beer For My Horses : Toby Keith Duet With Willie Nelson
Beware Of The Boys (Mundian To Bach Ke) : Panjabi MC Featuring Jay-Z
Big Star : Kenny Chesney
Bigger Than My Body : John Mayer
Blowin' Me Up (With Her Love) : JC Chasez
Breathe : Michelle Branch
Bright Lights : matchbox twenty
Bring Me To Life : Evanescence Featuring Paul McCoy
Brokenheartsville : Joe Nichols
Bump, Bump, Bump : B2K & P. Diddy
Calling All Angels : Train
Can't Hold Us Down : Christina Aguilera Featuring Lil' Kim
Can't Let You Go : Fabolous Featuring Mike Shorey & Lil' Mo
Can't Stop, Won't Stop : Young Gunz
Celebrity : Brad Paisley
Change Clothes : Jay-Z
Clocks : Coldplay
Clubbin : Marques Houston Featuring Joe Budden & Pied Piper
Come Over : Aaliyah
Cowboys Like Us : George Strait
Crazy In Love : Beyonce Featuring Jay-Z
Cry Me A River : Justin Timberlake
Damn! : YoungBloodZ Featuring Lil Jon
Dance With My Father : Luther Vandross
Did My Time : Korn
Dilemma : Nelly Featuring Kelly Rowland
Do That... : Baby Featuring P. Diddy
Don't Know Why : Norah Jones
Don't Mess With My Man : Nivea Featuring Brian & Brandon Casey
Don't Wanna Try : Frankie J
Drift Away : Uncle Kracker Featuring Dobie Gray
Emotional Rollercoaster : Vivian Green
Excuse Me Miss : Jay-Z
Fabulous : Jaheim Featuring Tha Rayne
Fall Into Me : Emerson Drive
Family Portrait : Pink
Fighter : Christina Aguilera
Flying Without Wings : Ruben Studdard
Forever And For Always : Shania Twain
Frontin' : Pharrell Featuring Jay-Z
Get Busy : Sean Paul
Get Low : Lil Jon & The East Side Boyz Featuring Ying Yang Twins
Gigolo : Nick Cannon Featuring R. Kelly
Gimme The Light : Sean Paul
Girlfriend : B2K
God Bless The U.S.A. : American Idol Finalists
Gossip Folks : Missy "Misdemeanor" Elliott Featuring Ludacris
Harder To Breathe : Maroon5
Have You Forgotten? : Darryl Worley
Headstrong : Trapt
Hell Yeah : Ginuwine Featuring Baby
Help Pour Out The Rain (Lacey's Song) : Buddy Jewell
Here Without You : 3 Doors Down
Hey Ma : Cam'ron Featuring Juelz Santana, Freekey Zekey & Toya
Hey Ya! : OutKast
Holidae In : Chingy Featuring Ludacris & Snoop Dogg
How You Gonna Act Like That : Tyrese
I Believe : Diamond Rio
I Can : Nas
I Just Wanna Be Mad : Terri Clark
I Know What You Want : Busta Rhymes & Mariah Carey Featuring The Flipmode Squad
I Love This Bar : Toby Keith
I Melt : Rascal Flatts
I Should Be... : Dru Hill
I Want You : Thalia Featuring Fat Joe
I'm Glad : Jennifer Lopez
I'm With You : Avril Lavigne
If You're Not The One : Daniel Bedingfield
Ignition : R. Kelly
In Da Club : 50 Cent
In Those Jeans : Ginuwine
Into You : Fabolous Featuring Tamia Or Ashanti
Intuition : Jewel
It's Five O'Clock Somewhere : Alan Jackson & Jimmy Buffett
It's My Life : No Doubt
Jenny From The Block : Jennifer Lopez Featuring Jadakiss & Styles
Landslide : Dixie Chicks
Let's Get Down : Bow Wow Featuring Baby
Lifestyles Of The Rich And Famous : Good Charlotte
Like A Stone : Audioslave
Like Glue : Sean Paul
Lose Yourself : Eminem
Love At 1st Sight : Mary J. Blige Featuring Method Man
Love Of My Life (An Ode To Hip Hop) : Erykah Badu Featuring Common
Love You Out Loud : Rascal Flatts
Luv U Better : LL Cool J
Made You Look : Nas
Magic Stick : Lil' Kim Featuring 50 Cent
Man To Man : Gary Allan
Me Against The Music : Britney Spears Featuring Madonna
Me, Myself And I : Beyonce
Mesmerize : Ja Rule Featuring Ashanti
Milkshake : Kelis
Miss Independent : Kelly Clarkson
Miss You : Aaliyah
My Front Porch Looking In : Lonestar
My Love Is Like... Wo : Mya
Never Leave You - Uh Ooh, Uh Oooh! : Lumidee
Never Scared : Bone Crusher Featuring Killer Mike & T.I.
No Letting Go : Wayne Wonder
No Shoes, No Shirt, No Problems : Kenny Chesney
Numb : Linkin Park
One Last Breath : Creed
Ooh! : Mary J. Blige
P.I.M.P. : 50 Cent
Paradise : LL Cool J Featuring Amerie
Pass That Dutch : Missy Elliott
Perfect : Simple Plan
Picture : Kid Rock Featuring Sheryl Crow
Picture : Kid Rock Featuring Sheryl Crow Or Allison Moorer
Pump It Up : Joe Budden
Put That Woman First : Jaheim
Rain On Me : Ashanti
Raining On Sunday : Keith Urban
Read Your Mind : Avant
Real Good Man : Tim McGraw
Red Dirt Road : Brooks & Dunn
Right Thurr : Chingy
Rock Wit U (Awww Baby) : Ashanti
Rock Your Body : Justin Timberlake
Runnin (Dying To Live) : Tupac Featuring The Notorious B.I.G.
Salt Shaker : Ying Yang Twins Featuring Lil Jon & The East Side Boyz
Satisfaction : Eve
Say Yes : Floetry
Senorita : Justin Timberlake
Shake Ya Tailfeather : Nelly, P. Diddy & Murphy Lee
She Hates Me : Puddle Of Mudd
She'll Leave You With A Smile : George Strait
She's My Kind Of Rain : Tim McGraw
Sick Of Being Lonely : Field Mob
Sing For The Moment : Eminem
Slow Jamz : Twista Featuring Kanye West & Jamie Foxx
Snake : R. Kelly Featuring Big Tigger
So Far Away : Staind
So Gone : Monica
Someday : Nickelback
Something : Lasgo
Somewhere I Belong : Linkin Park
Stacy's Mom : Fountains Of Wayne
Stand Up : Ludacris Featuring Shawnna
Stay Gone : Jimmy Wayne
Step In The Name Of Love : R. Kelly
Stunt 101 : G-Unit
Suga Suga : Baby Bash Featuring Frankie J
Superman : Eminem
Tell Me (What's Goin' On) : Smilez & Southstar
That'd Be Alright : Alan Jackson
The Baby : Blake Shelton
The Boys Of Summer : The Ataris
The First Cut Is The Deepest : Sheryl Crow
The Game Of Love : Santana Featuring Michelle Branch
The Jump Off : Lil' Kim Featuring Mr. Cheeks
The Remedy (I Won't Worry) : Jason Mraz
The Voice Within : Christina Aguilera
The Way You Move : OutKast Featuring Sleepy Brown
There Goes My Life : Kenny Chesney
These Days : Rascal Flatts
This Is The Night : Clay Aiken
This One's For The Girls : Martina McBride
Thoia Thoing : R. Kelly
Three Wooden Crosses : Randy Travis
Through The Wire : Kanye West
Thugz Mansion : 2Pac
Tough Little Boys : Gary Allan
Travelin' Soldier : Dixie Chicks
Underneath It All : No Doubt Featuring Lady Saw
Unwell : matchbox twenty
Walked Outta Heaven : Jagged Edge
Wanksta : 50 Cent
Wat Da Hook Gon Be : Murphy Lee Featuring Jermaine Dupri
Wave On Wave : Pat Green
What Was I Thinkin' : Dierks Bentley
When I'm Gone : 3 Doors Down
When The Last Time : Clipse
Where Is The Love? : Black Eyed Peas
White Flag : Dido
Who Wouldn't Wanna Be Me : Keith Urban
Who's Your Daddy? : Toby Keith
Why Can't I : Liz Phair
Why Don't You & I : Santana Featuring Alex Band Or Chad Kroeger
Work It : Missy "Misdemeanor" Elliott
You Can't Hide Beautiful : Aaron Lines
You Don't Know My Name : Alicia Keys
Your Body Is A Wonderland : John Mayer
dontchange : Musiq
