1 Thing : Amerie
1, 2 Step : Ciara Featuring Missy Elliott
A Real Fine Place To Start : Sara Evans
Across The Universe : Various Artists
Alcohol : Brad Paisley
American Baby : Dave Matthews Band
As Good As I Once Was : Toby Keith
Awful, Beautiful Life : Darryl Worley
B.Y.O.B. : System Of A Down
Baby Girl : Sugarland
Baby I'm Back : Baby Bash Featuring Akon
Back Then : Mike Jones
Back When : Tim McGraw
Badd : Ying Yang Twins Featuring Mike Jones & Mr. ColliPark
Be Without You : Mary J. Blige
Be Yourself : Audioslave
Beautiful Soul : Jesse McCartney
Because Of You : Kelly Clarkson
Behind These Hazel Eyes : Kelly Clarkson
Belly Dancer (Bananza) : Akon
Best Of You : Foo Fighters
Better Days : Goo Goo Dolls
Beverly Hills : Weezer
Bless The Broken Road : Rascal Flatts
Boulevard Of Broken Dreams : Green Day
Boyfriend : Ashlee Simpson
Breakaway : Kelly Clarkson
Breathe : Fabolous
Bring Em Out : T.I.
Broken : Seether Featuring Amy Lee
Candy Shop : 50 Cent Featuring Olivia
Cater 2 U : Destiny's Child
Caught Up : Usher
Chariot : Gavin DeGraw
Charlene : Anthony Hamilton
Check On It : Beyonce Featuring Slim Thug
Collide : Howie Day
Come A Little Closer : Dierks Bentley
Cool : Gwen Stefani
Cry Baby/Piece Of My Heart : Melissa Etheridge & Joss Stone
Dance, Dance : Fall Out Boy
Dare You To Move : Switchfoot
Daughters : John Mayer
Dirty Little Secret : The All-American Rejects
Disco Inferno : 50 Cent
Don't Cha : The Pussycat Dolls Featuring Busta Rhymes
Don't Forget About Us : Mariah Carey
Don't Lie : The Black Eyed Peas
Don't Phunk With My Heart : The Black Eyed Peas
Dreams : The Game
Drop It Like It's Hot : Snoop Dogg Featuring Pharrell
Encore : Eminem Featuring Dr. Dre & 50 Cent
Errtime : Nelly Featuring Jung Tru & King Jacob
Fast Cars And Freedom : Rascal Flatts
Feel Good Inc : Gorillaz
Feel Good Inc : Gorillaz/De La Soul
Fireman : Lil' Wayne
Gasolina : Daddy Yankee
Get Back : Ludacris
Get It Poppin' : Fat Joe Featuring Nelly
Get Right : Jennifer Lopez
Girl : Destiny's Child
Girl Tonite : Twista Featuring Trey Songz
Girlfight : Brooke Valentine Featuring Lil Jon & Big Boi
Give A Little Bit : Goo Goo Dolls
Give Me That : Webbie Featuring Bun B
Go D.J. : Lil Wayne
Goin' Crazy : Natalie
Gold Digger : Kanye West Featuring Jamie Foxx
Goodies : Ciara Featuring Petey Pablo
Grillz : Nelly Featuring Paul Wall, Ali & Gipp
Grind With Me : Pretty Ricky
Hate It Or Love It : The Game Featuring 50 Cent
Heard 'Em Say : Kanye West Featuring Adam Levine
Helena (So Long & Goodnight) : My Chemical Romance
Here We Go : Trina Featuring Kelly Rowland
Holiday : Green Day
Hollaback Girl : Gwen Stefani
Honky Tonk Badonkadonk : Trace Adkins
Hope : Twista Featuring Faith Evans
How To Deal : Frankie J
How We Do : The Game Featuring 50 Cent
Hung Up : Madonna
I Don't Want To Be : Gavin DeGraw
I Should Have Cheated : Keyshia Cole
I Think They Like Me : Dem Franchize Boyz Featuring Jermaine Dupri, Da Brat & Bow Wow
I'm A Hustla : Cassidy
I'm Sprung : T-Pain
If It's Lovin' That You Want : Rihanna
Incomplete : Backstreet Boys
Inside Your Heaven : Bo Bice
Inside Your Heaven : Carrie Underwood
It's Like That : Mariah Carey
Jesus, Take The Wheel : Carrie Underwood
Just A Lil Bit : 50 Cent
Just The Girl : The Click Five
Karma : Alicia Keys
Karma : Lloyd Banks Featuring Avant
Kryptonite (I'm On It) : Purple Ribbon All-Stars
La Tortura : Shakira Featuring Alejandro Sanz
Lady : Lenny Kravitz
Laffy Taffy : D4L
Lean Back : Terror Squad
Let Me Go : 3 Doors Down
Let Me Hold You : Bow Wow Featuring Omarion
Let Me Love You : Mario
Let's Go : Trick Daddy Featuring Lil Jon & Twista
Lighters Up : Lil' Kim
Like Toy Soldiers : Eminem
Like You : Bow Wow Featuring Ciara
Listen To Your Heart : D.H.T.
Live Like You Were Dying : Tim McGraw
Lonely : Akon
Lonely No More : Rob Thomas
Look What You've Done : Jet
Lose Control : Missy Elliott Featuring Ciara & Fat Man Scoop
Lose My Breath : Destiny's Child
Lovers And Friends : Lil Jon & The East Side Boyz Featuring Usher & Ludacris
Luxurious : Gwen Stefani
Make Her Feel Good : Teairra Mari
Making Memories Of Us : Keith Urban
Mississippi Girl : Faith Hill
Mockingbird : Eminem
More Than Words : Frankie J
Mr. Brightside : The Killers
Mud On The Tires : Brad Paisley
Must Be Doin' Somethin' Right : Billy Currington
Must Be Nice : Lyfe Jennings
My Boo : Usher And Alicia Keys
My Humps : The Black Eyed Peas
New York : Ja Rule Featuring Fat Joe & Jadakiss
Nothin' To Lose : Josh Gracin
Numb/Encore : Jay-Z/Linkin Park
Number One Spot : Ludacris
O : Omarion
Obsession (No Es Amor) : Frankie J Featuring Baby Bash
Oh : Ciara Featuring Ludacris
Okay : Nivea Featuring Lil Jon & YoungBloodZ
On The Way Down : Ryan Cabrera
One Thing : Finger Eleven
One Wish : Ray J
Only U : Ashanti
Ordinary People : John Legend
Outta Control (Remix) : 50 Cent Feat. Mobb Deep
Outta Control (Remix) : 50 Cent Featuring Mobb Deep
Over And Over : Nelly Featuring Tim McGraw
Oye Mi Canto : N.O.R.E. Featuring Daddy Yankee, Nina Sky, Gem Star & Big Mato
Photograph : Nickelback
Pimpin' All Over The World : Ludacris Featuring Bobby Valentino
Play : David Banner
Play Something Country : Brooks & Dunn
Pon de Replay : Rihanna
Pretty Vegas : INXS
Rich Girl : Gwen Stefani Featuring Eve
Run It! : Chris Brown
Scars : Papa Roach
Seasons Of Love : Cast Of Rent
Shake It Off : Mariah Carey
She Will Be Loved : Maroon5
Since U Been Gone : Kelly Clarkson
Slow Down : Bobby Valentino
So Sick : Ne-Yo
Soldier : Destiny's Child
Soldier : Destiny's Child Featuring T.I. & Lil Wayne
Some Beach : Blake Shelton
Some Cut : Trillville Featuring Cutty
Something More : Sugarland
Soul Survivor : Young Jeezy Featuring Akon
Speed Of Sound : Coldplay
Stay Fly : Three 6 Mafia Featuring Young Buck & Eightball & MJG
Stickwitu : The Pussycat Dolls
Sugar (Gimme Some) : Trick Daddy Featuring Ludacris, Lil' Kim & Cee-Lo
Sugar, We're Goin' Down : Fall Out Boy
Summer Nights : Lil Rob
Sunday Morning : Maroon5
Switch : Will Smith
Tequila Makes Her Clothes Fall Off : Joe Nichols
The Hand That Feeds : Nine Inch Nails
There It Go! (The Whistle Song) : Juelz Santana
These Boots Are Made For Walkin' : Jessica Simpson
These Words : Natasha Bedingfield
Trapped In The Closet : R. Kelly
True : Ryan Cabrera
Truth Is : Fantasia
U Already Know : 112 Featuring Foxy Brown
U Don't Know Me : T.I.
U Make Me Wanna : Jadakiss Featuring Mariah Carey
Unbreakable : Alicia Keys
Vertigo : U2
Wait (The Whisper Song) : Ying Yang Twins
Wake Me Up When September Ends : Green Day
Wake Up : Hilary Duff
We Be Burnin' : Sean Paul
We Belong Together : Mariah Carey
What U Gon' Do : Lil Jon & The East Side Boyz Featuring Lil Scrappy
When I Think About Cheatin' : Gretchen Wilson
When I'm Gone : Eminem
When You Tell Me That You Love Me : American Idol Finalists Season 4
Who You'd Be Today : Kenny Chesney
Window Shopper : 50 Cent
Wonderful : Ja Rule Featuring R. Kelly & Ashanti
You And Me : Lifehouse
You're Beautiful : James Blunt
You're My Better Half : Keith Urban
Your Body : Pretty Ricky
