(I Can't Help You) I'm Falling Too : Skeeter Davis
(I Do The) Shimmy Shimmy : Bobby Freeman
(There Was A) Tall Oak Tree : Dorsey Burnette
(Welcome) New Lovers : Pat Boone
A Fool In Love : Ike & Tina Turner
A Million To One : Jimmy Charles and The Revelletts
A Rockin' Good Way (To Mess Around And Fall In Love) : Dinah Washington & Brook Benton
A Thousand Stars : Kathy Young with The Innocents
All I Could Do Was Cry : Etta James
Alley-Oop : Dante and the Evergreens
Alley-Oop : Hollywood Argyles
Always : Sammy Turner
Am I That Easy To Forget : Debbie Reynolds
Angel Baby : Rosie And The Originals
Angela Jones : Johnny Ferguson
Another Sleepless Night : Jimmy Clanton
Anymore : Teresa Brewer
Apple Green : June Valli
Artificial Flowers : Bobby Darin
Baby What You Want Me To Do : Jimmy Reed
Ballad Of The Alamo : Marty Robbins
Barbara : The Temptations
Beatnik Fly : Johnny And The Hurricanes
Because They're Young : Duane Eddy And The Rebels
Blue Angel : Roy Orbison
Bulldog : The Fireballs
Burning Bridges : Jack Scott
Cathy's Clown : The Everly Brothers
Cherry Pie : Skip And Flip
China Doll : The Ames Brothers
Corinna, Corinna : Ray Peterson
Cradle Of Love : Johnny Preston
Crazy Arms : Bob Beckham
Delaware : Perry Como
Diamonds And Pearls : The Paradons
Doll House : Donnie Brooks
Don't Go To Strangers : Etta Jones
Dutchman's Gold : Walter Brennan With Billy Vaughn and his Orchestra
El Matador : The Kingston Trio
Everybody's Somebody's Fool : Connie Francis
Exodus : Ferrante & Teicher
Fannie Mae : Buster Brown
Fools Rush In (Where Angels Fear To Tread) : Brook Benton
Forever : The Little Dippers
Good Timin' : Jimmy Jones
Got A Girl : The Four Preps
Greenfields : The Brothers Four
Happy-Go-Lucky-Me : Paul Evans
He Will Break Your Heart : Jerry Butler
He'll Have To Go : Jim Reeves
He'll Have To Stay : Jeanne Black
Heartaches By The Number : Guy Mitchell
Honest I Do : The Innocents
Hot Rod Lincoln : Charlie Ryan and the Timberline Riders
Hot Rod Lincoln : Johnny Bond
Hound Dog Man : Fabian
How About That : Dee Clark
I Really Don't Want To Know : Tommy Edwards
I'll Save The Last Dance For You : Damita Jo
If I Had A Girl : Rod Lauren
Image Of A Girl : Safaris with The Phantom's Band
In The Mood : Ernie Fields & Orch.
Itsy Bitsy Teenie Weenie Yellow Polkadot Bikini : Brian Hyland
Jingle Bell Rock : Bobby Helms
Jump Over : Freddy Cannon
Just Come Home : Hugo & Luigi
Just One Time : Don Gibson
Last Date : Floyd Cramer
Last Date : Lawrence Welk And His Orchestra
Let The Little Girl Dance : Billy Bland
Let's Go, Let's Go, Let's Go : Hank Ballard And The Midnighters
Let's Have A Party : Wanda Jackson
Let's Think About Living : Bob Luman
Little Coco Palm : Jerry Wallace
Little Things Mean A Lot : Joni James
Lonely Blue Boy : Conway Twitty
Lonely Teenager : Dion
Lonely Weekends : Charlie Rich
Look For A Star - Part I : Garry Mills
Look For A Star : Billy Vaughn And His Orchestra
Look For A Star : Deane Hawley
Look For A Star : Garry Miles
Love Walked In : Dinah Washington
Love You So : Ron Holden with The Thunderbirds
Lucky Devil : Carl Dobkins, Jr.
Mack The Knife : Ella Fitzgerald
Marina : Rocco Granata and the International Quintet
Money (That's what I want) : Barrett Strong
Mountain Of Love : Harold Dorman
Mr. Custer : Larry Verne
Mr. Lucky : Henry Mancini
Mule Skinner Blues : The Fendermen
My Girl Josephine : Fats Domino
Never On Sunday : Don Costa And His Orchestra And Chorus
New Orleans : U.S. Bonds
Night : Jackie Wilson
No If's - No And's : Lloyd Price and His Orchestra
Nobody Loves Me Like You : The Flamingos
Not One Minute More : Della Reese
O Dio Mio : Annette
Ol' Mac Donald : Frank Sinatra
One Of Us (Will Weep Tonight) : Patti Page
Ooh Poo Pah Doo - Part II : Jessie Hill
Over The Rainbow : The Demensions
Paper Roses : Anita Bryant
Pennies From Heaven : The Skyliners
Perfidia : The Ventures
Peter Gunn : Duane Eddy His Twangy Guitar And The Rebels
Pineapple Princess : Annette With The Afterbeats
Please Help Me, I'm Falling : Hank Locklin
Poetry In Motion : Johnny Tillotson
Pretty Blue Eyes : Steve Lawrence
Red Sails In The Sunset : The Platters Featuring Tony Williams
Rockin' Around The Christmas Tree : Brenda Lee
Rockin' Little Angel : Ray Smith
Rubber Ball : Bobby Vee
Ruby : Ray Charles
Ruby Duby Du : Tobin Mathews & Co.
Rudolph The Red Nosed Reindeer : David Seville And The Chipmunks
Run Red Run : The Coasters
Runaround : The Fleetwoods
Sailor (Your Home Is The Sea) : Lolita
Sandy : Larry Hall
Save The Last Dance For Me : The Drifters
Scarlet Ribbons (For Her Hair) : The Browns
Shimmy, Shimmy, Ko-Ko-Bop : Little Anthony And The Imperials
Sink The Bismark : Johnny Horton
Sixteen Reasons : Connie Stevens
Sleep : Little Willie John
Stairway To Heaven : Neil Sedaka
Starbright : Johnny Mathis
Stay : Maurice Williams & The Zodiacs
Step By Step : The Crests
Sticks And Stones : Ray Charles and his Orchestra
Stuck On You : Elvis Presley With The Jordanaires
Summer Set : Monty Kelly And His Orchestra
Summer's Gone : Paul Anka
Swingin' School : Bobby Rydell
T.L.C. Tender Love And Care : Jimmie Rodgers
Ta Ta : Clyde McPhatter
Tear Drop : Santo & Johnny
Teen Angel : Mark Dinning
The Big Hurt : Miss Toni Fisher
The Happy Reindeer : Dancer, Prancer And Nervous
The Hucklebuck : Chubby Checker
The Little Drummer Boy : The Harry Simeone Chorale
The Madison : Al Brown's Tunetoppers featuring Cookie Brown
The Madison Time - Part I : Ray Bryant Combo
The Old Lamplighter : The Browns featuring Jim Edward Brown
The Village Of St. Bernadette : Andy Williams
Theme For Young Lovers : Percy Faith And His Orchestra
There's Something On Your Mind (Part 2) : Bobby Marchan
Think : James Brown And The Famous Flames
Time And The River : Nat King Cole
To Each His Own : The Platters
Togetherness : Frankie Avalon
Too Much Tequila : The Champs
Tracy's Theme : Spencer Ross
Twistin' U.S.A. : Danny & The Juniors
Uh! Oh! Part 2 : The Nutty Squirrels
Wait For Me : The Playmates
Way Down Yonder In New Orleans : Freddie Cannon
Where Or When : Dion & The Belmonts
White Christmas : Bing Crosby
White Silver Sands : Bill Black's Combo
Will You Love Me Tomorrow : The Shirelles
Wings Of A Dove : Ferlin Husky
Wonderful World : Sam Cooke
Wonderland By Night : Bert Kaempfert And His Orchestra
Wonderland By Night : Louis Prima
Yogi : The Ivy Three
You Got What It Takes : Marv Johnson
You Talk Too Much : Joe Jones
You're Sixteen : Johnny Burnette
Young Emotions : Ricky Nelson
