(Down At) Papa Joe's : The Dixiebelles
(I Love You) Don't You Forget It : Perry Como
18 Yellow Roses : Bobby Darin
A Walkin' Miracle : The Essex Featuring Anita Humes
Abilene : George Hamilton IV
Alice In Wonderland : Neil Sedaka
All I Have To Do Is Dream : Richard Chamberlain
Be Careful Of Stones That You Throw : Dion
Be My Baby : The Ronettes
Birdland : Chubby Checker
Birthday Party : The Pixies Three
Blame It On The Bossa Nova : Eydie Gorme
Blue On Blue : Bobby Vinton
Bobby's Girl : Marcie Blane
Boss Guitar : Duane Eddy and the Rebelettes
Bossa Nova Baby : Elvis Presley With The Jordanaires
Bust Out : The Busters
Busted : Ray Charles and his Orchestra
Call On Me : Bobby Bland
Candy Girl : The 4 Seasons
Cast Your Fate To The Wind : Vince Guaraldi Trio
Charms : Bobby Vee
Come And Get These Memories : Martha & The Vandellas
Cry Baby : Garnet Mimms & The Enchanters
Cry To Me : Betty Harris
Da Doo Ron Ron (When He Walked Me Home) : The Crystals
Danke Schoen : Wayne Newton And The Newton Brothers
Days Of Wine And Roses : Henry Mancini And His Orchestra
Deep Purple : Nino Tempo & April Stevens
Denise : Randy & The Rainbows
Desert Pete : The Kingston Trio
Detroit City : Bobby Bare
Dominique : The Singing Nun (Soeur Sourire)
Don't Make Me Over : Dionne Warwick
Don't Say Nothin' Bad (About My Baby) : The Cookies
Don't Think Twice, It's All Right : Peter, Paul & Mary
Donna The Prima Donna : Dion (Di Muci)
Down The Aisle (Wedding Song) : Patti LaBelle And The Blue Belles
Drip Drop : Dion Di Muci
Easier Said Than Done : The Essex
El Watusi : Ray Barretto
Everybody : Tommy Roe
Falling : Roy Orbison
Fingertips - Pt 2 : Little Stevie Wonder
First Quarrel : Paul and Paula
Fly Me To The Moon - Bossa Nova : Joe Harnell And His Orchestra
Foolish Little Girl : The Shirelles
From A Jack To A King : Ned Miller
Goodnight My Love : The Fleetwoods
Harry The Hairy Ape : Ray Stevens
Hello Mudduh, Hello Fadduh! (A Letter From Camp) : Allan Sherman
Hello Stranger : Barbara Lewis
Hey Little Girl : Major Lance
Hey, Girl : Freddie Scott
Hootenanny : The Glencoves
Hopeless : Andy Williams
Hot Pastrami : The Dartells
Hot Pastrami With Mashed Potatoes - Part I : Joey Dee & the Starliters
I (Who Have Nothing) : Ben E. King
I Adore Him : The Angels
I Can't Stay Mad At You : Skeeter Davis
I Got What I Wanted : Brook Benton
I Love You Because : Al Martino
I Saw Linda Yesterday : Dickey Lee
I Want To Stay Here : Steve & Eydie
I Wish I Were A Princess : Little Peggy March
I Wonder What She's Doing Tonight : Barry & The Tamerlanes
I'm Leaving It Up To You : Dale & Grace
If I Had A Hammer : Trini Lopez
If My Pillow Could Talk : Connie Francis
If You Need Me : Solomon Burke
If You Wanna Be Happy : Jimmy Soul
It's All Right : The Impressions
It's My Party : Lesley Gore
Just One Look : Doris Troy
Keep Your Hands Off My Baby : Little Eva
Killer Joe : The Rocky Fellers
Let's Go (pony) : The Routers
Little Band Of Gold : James Gilreath
Little Red Rooster : Sam Cooke
Little Town Flirt : Del Shannon
Loop De Loop : Johnny Thunder
Louie Louie : The Kingsmen
Love (Makes the World Go 'Round) : Paul Anka
Make The World Go Away : Timi Yuro
Mama Didn't Lie : Jan Bradley
Maria Elena : Los Indios Tabajaras
Martian Hop : The Ran-Dells
Memphis : Lonnie Mack
Mickey's Monkey : The Miracles
Midnight Mary : Joey Powers
Misty : Lloyd Price
Mockingbird : Inez Foxx with Charlie Foxx
Monsters' Holiday : Bobby Boris Pickett And The Crypt-Kickers
More : Kai Winding & Orchestra
Mr. Bass Man : Johnny Cymbal
My Coloring Book : Kitty Kallen
My Coloring Book : Sandy Stewart
My Dad : Paul Petersen
My Summer Love : Ruby And The Romantics
My Whole World Is Falling Down : Brenda Lee
Need To Belong : Jerry Butler
No One : Ray Charles
Not Me : The Orlons
On Broadway : The Drifters
On Top Of Spaghetti : Tom Glazer And The Do-Re-Mi Children's Chorus
One Broken Heart For Sale : Elvis Presley With The Mello Men
One Fine Day : The Chiffons
Only In America : Jay & The Americans
Our Winter Love : Bill Pursell
Out Of Limits : The Marketts
Part Time Love : Little Johnny Taylor
Pepino The Italian Mouse : Lou Monte
Pipeline : Chantay's
Please Don't Talk To The Lifeguard : Diane Ray
Popsicles And Icicles : The Murmaids
Pride And Joy : Marvin Gaye
Prisoner Of Love : James Brown And The Famous Flames
Proud : Johnny Crawford
Pushover : Etta James
Red Sails In The Sunset : Fats Domino
Release Me : Esther Phillips Little Esther
Remember Then : The Earls
Rhythm Of The Rain : The Cascades
Ring Of Fire : Johnny Cash
Ruby Ann : Marty Robbins
Sally, Go 'Round The Roses : The Jaynetts
Saturday Night : The New Christy Minstrels
See See Rider : LaVern Baker
Shake! Shake! Shake! : Jackie Wilson
Shut Down : The Beach Boys
Shutters And Boards : Jerry Wallace
Since I Fell For You : Lenny Welch
Six Days On The Road : Dave Dudley
So Much In Love : The Tymes
Still : Bill Anderson
String Along : Rick Nelson
Sugar Shack : Jimmy Gilmer And The Fireballs
Sukiyaki : Kyu Sakamoto
Surf City : Jan & Dean
Surfin' Bird : The Trashmen
Swinging On A Star : Big Dee Irwin (with Little Eva)
Talk To Me : Sunny & The Sunglows
Tell Him : The Exciters
Telstar : The Tornadoes
That's How Heartaches Are Made : Baby Washington
The Bounce : The Olympics
The Boy Next Door : The Secrets
The Cinnamon Cinder (It's A Very Nice Dance) : The Pastel Six
The Good Life : Tony Bennett
The Kind Of Boy You Can't Forget : The Raindrops
The Lonely Bull (El Solo Torro) : The Tijuana Brass
The Lonely Surfer : Jack Nitzsche
The Love Of My Man : Theola Kilgore
The Nitty Gritty : Shirley Ellis
Those Lazy-Hazy-Crazy Days Of Summer : Nat King Cole
Tie Me Kangaroo Down, Sport : Rolf Harris
Till Then : The Classics
Tom Cat : The Rooftop Singers
Tra La La La Suzy : Dean And Jean
Twenty Four Hours From Tulsa : Gene Pitney
Two Faces Have I : Lou Christie
Wait Til' My Bobby Gets Home : Darlene Love
Walking Proud : Steve Lawrence
Walking The Dog : Rufus Thomas
Washington Square : The Village Stompers
Watermelon Man : Mongo Santamaria Band
What Will My Mary Say : Johnny Mathis
When The Lovelight Starts Shining Through His Eyes : The Supremes
Why Don't You Believe Me : The Duprees featuring Joey Vann
Wiggle Wobble : Les Cooper and the Soul Rockers
Wild Weekend : The Rebels
Wild! : Dee Dee Sharp
Wildwood Days : Bobby Rydell
Wipe Out : The Surfaris
Wives And Lovers : Jack Jones
Wonderful Summer : Robin Ward
Yakety Sax : Boots Randolph and his Combo
You Can Never Stop Me Loving You : Johnny Tillotson
You Can't Sit Down : The Dovells
You Don't Have To Be A Baby To Cry : The Caravelles
Young And In Love : Dick and DeeDee
Your Old Stand By : Mary Wells
Zip-A-Dee Doo-Dah : Bob B. Soxx And The Blue Jeans
