(Just Like) Romeo & Juliet : The Reflections
(The Best Part Of) Breakin' Up : The Ronettes
(You Don't Know) How Glad I Am : Nancy Wilson
20-75 : Willie Mitchell
A Summer Song : Chad & Jeremy
Abigail Beecher : Freddy Cannon
Ain't Nothing You Can Do : Bobby Bland
Ain't That Loving You Baby : Elvis Presley
Always Together : Al Martino
As Tears Go By : Marianne Faithfull
Baby I Need Your Loving : Four Tops
Baby, Don't You Cry (The New Swingova Rhythm) : Ray Charles and his Orchestra
Be Anything (But Be Mine) : Connie Francis
Bird Dance Beat : The Trashmen
Bits And Pieces : The Dave Clark Five
Bread And Butter : The Newbeats
C'mon And Swim : Bobby Freeman
California Sun : The Rivieras
Can't Buy Me Love : The Beatles
Charade : Sammy Kaye And His Orchestra
Chug-A-Lug : Roger Miller
Clinging Vine : Bobby Vinton
Come A Little Bit Closer : Jay & The Americans
Come On : Tommy Roe
Cotton Candy : Al Hirt
Cousin Of Mine : Sam Cooke
Daisy Petal Pickin' : Jimmy Gilmer And The Fireballs
Dancing In The Street : Martha & The Vandellas
Dawn (Go Away) : The 4 Seasons
Dead Man's Curve : Jan & Dean
Diane : The Bachelors
Do Wah Diddy Diddy : Manfred Mann
Dominique : The Singing Nun (Soeur Sourire)
Don't Let The Rain Come Down (Crooked Little Man) : The Serendipity Singers
Drip Drop : Dion Di Muci
Ebb Tide : Lenny Welch
Every Little Bit Hurts : Brenda Holloway
Everybody Loves Somebody : Dean Martin
Farmer John : The Premiers
For Your Precious Love : Garnet Mimms & The Enchanters
Forever : Pete Drake And His Talking Steel Guitar
Forget Him : Bobby Rydell
Funny (How Time Slips Away) : Joe Hinton
G.T.O. : Ronny And The Daytonas
Girls Grow Up Faster Than Boys : The Cookies
Giving Up : Gladys Knight And The Pips
Going Going Gone : Brook Benton
Gone, Gone, Gone : The Everly Brothers
Goodbye Baby (Baby Goodbye) : Solomon Burke
Handy Man : Del Shannon
Haunted House : Gene Simmons
Have I The Right? : The Honeycombs
Have You Heard : The Duprees featuring Joey Vann
Hello, Dolly! : Louis Armstrong And The All Stars
Hey Harmonica Man : Stevie Wonder
Hey, Bobba Needle : Chubby Checker
Hi-Heel Sneakers : Tommy Tucker
Hippy Hippy Shake : The Swinging Blue Jeans
How Do You Do It? : Gerry And The Pacemakers
I Can't Stop Talking About You : Steve & Eydie
I Don't Want To See Tomorrow : Nat King Cole
I Don't Want To See You Again : Peter And Gordon
I Get Around : The Beach Boys
I Gotta Dance To Keep From Crying : The Miracles
I Have A Boyfriend : The Chiffons
I Rise, I Fall : Johnny Tillotson
I Wanna Love Him So Bad : The Jelly Beans
I Wish You Love : Gloria Lynne
I'm Into Somethin' Good : Earl-Jean
I'm Into Something Good : Herman's Hermits
I'm On The Outside (Looking In) : Little Anthony And The Imperials
I'm So Proud : The Impressions
In The Misty Moonlight : Jerry Wallace
Is It True : Brenda Lee
It Hurts To Be In Love : Gene Pitney
It's All In The Game : Cliff Richard
It's All Over Now : The Rolling Stones
It's Over : Roy Orbison
Java : Al (He's the King) Hirt
Just Be True : Gene Chandler
Kansas City : Trini Lopez
Kiss Me Sailor : Diane Renay
Last Kiss : J. Frank Wilson and The Cavaliers
Leader Of The Laundromat : The Detergents
Let It Be Me : Betty Everett & Jerry Butler
Letter From Sherry : Dale Ward
Little Children : Billy J. Kramer With The Dakotas
Little Honda : The Hondells
Love Me With All Your Heart (Cuando Calienta El Sol) : The Ray Charles Singers
Maybelline : Johnny Rivers
Mercy, Mercy : Don Covay & The Goodtimers
Midnight Mary : Joey Powers
Miller's Cave : Bobby Bare
Mixed-Up, Shook-Up, Girl : Patty & The Emblems
Money : The Kingsmen
My Bonnie (My Bonnie Lies Over The Ocean) : The Beatles With Tony Sheridan
My Girl Sloopy : The Vibrations
My Guy : Mary Wells
My Love, Forgive Me (Amore, Scusami) : Robert Goulet
Nadine (Is It You?) : Chuck Berry
Need To Belong : Jerry Butler
Needles And Pins : The Searchers
Oh Baby Don't You Weep (Part 1) : James Brown And The Famous Flames
Oh No Not My Baby : Maxine Brown
Oh, Pretty Woman : Roy Orbison And The Candy Men
Once Upon A Time : Marvin Gaye & Mary Wells
Out Of Limits : The Marketts
Out Of Sight : James Brown And His Orchestra
Penetration : The Pyramids
People : Barbra Streisand
People Say : The Dixie Cups
Popsicles And Icicles : The Murmaids
Puppy Love : Barbara Lewis
Reach Out For Me : Dionne Warwick
Remember (Walkin' in the Sand) : The Shangri-Las
Remember Me : Rita Pavone
Right Or Wrong : Ronnie Dove
Ringo : Lorne Greene
Rip Van Winkle : The Devotions
Rock Me Baby : B.B. King
Ronnie : The 4 Seasons Featuring the Sound of Frankie Valli
See The Funny Little Clown : Bobby Goldsboro
Selfish One : Jackie Ross
Shaggy Dog : Mickey Lee Lane
Shangri-La : Robert Maxwell His Harp And Orchestra
Shangri-La : Vic Dana
She's Not There : The Zombies
She's The One : The Chartbusters
Softly, As I Leave You : Frank Sinatra
Somewhere : The Tymes
Southtown, U.S.A. : The Dixiebelles
Stay Awhile : Dusty Springfield
Steal Away : Jimmy Hughes
Stop And Think It Over : Dale & Grace
Such A Night : Elvis Presley With The Jordanaires
Suspicion : Terry Stafford
Sweet William : Millie Small
Tall Cool One : The Wailers
Tell It On The Mountain : Peter, Paul & Mary
That Lucky Old Sun : Ray Charles
That's The Way Boys Are : Lesley Gore
The Boy Next Door : The Secrets
The Girl From Ipanema : Stan Getz/Astrud Gilberto
The House Of The Rising Sun : The Animals
The Jerk : The Larks
The Matador : Major Lance
The Nitty Gritty : Shirley Ellis
The Pink Panther Theme : Henry Mancini And His Orchestra
The Shelter Of Your Arms : Sammy Davis Jr.
The Shoop Shoop Song (It's In His Kiss) : Betty Everett
The Very Thought Of You : Rick Nelson
The Way You Do The Things You Do : The Temptations
The Wedding : Julie Rogers
Thou Shalt Not Steal : Dick and DeeDee
Three Window Coupe : The Rip Chords
Tobacco Road : The Nashville Teens
Today : The New Christy Minstrels
Too Many Fish In The Sea : The Marvelettes
Tra La La La Suzy : Dean And Jean
Under The Boardwalk : The Drifters
Understand Your Man : Johnny Cash
Walk Away : Matt Monro
Walk-Don't Run '64 : The Ventures
We Love You Beatles : The Carefrees
We'll Sing In The Sunshine : Gale Garnett
What Kind Of Fool (Do You Think I Am) : The Tams
What'd I Say : Elvis Presley With The Jubilee Four And Carole Lombard Quartet
Where Did Our Love Go : The Supremes
Whispering : Nino Tempo & April Stevens
White On White : Danny Williams
Who Can I Turn To (When Nobody Needs Me) : Tony Bennett
Who Do You Love : The Sapphires
Wish Someone Would Care : Irma Thomas
Wives And Lovers : Jack Jones
Wrong For Each Other : Andy Williams
You Don't Have To Be A Baby To Cry : The Caravelles
You Really Got Me : The Kinks
You'll Never Walk Alone : Patti LaBelle And The Blue Belles
You're A Wonderful One : Marvin Gaye
You're My World : Cilla Black
You've Lost That Lovin' Feelin' : The Righteous Brothers
