A Boy Named Sue : Johnny Cash
A Brand New Me : Dusty Springfield
Abraham, Martin And John : Dion
Abraham, Martin And John : Moms Mabley
Along Came Jones : Ray Stevens
And When I Die : Blood, Sweat & Tears
Atlantis : Donovan
Baby It's You : Smith
Baby Let's Wait : The Royal Guardsmen
Baby, I Love You : Andy Kim
Baby, I'm For Real : The Originals
Backfield In Motion : Mel And Tim
Birthday : Underground Sunshine
Black Pearl : Sonny Charles & The Checkmates, Ltd.
Both Sides Now : Judy Collins
Bring It On Home To Me : Eddie Floyd
Build Me Up Buttercup : The Foundations
But You Know I Love You : The First Edition
By The Time I Get To Phoenix : Isaac Hayes
Can I Change My Mind : Tyrone Davis
Carry Me Back : The Rascals
Cherry Hill Park : Billy Joe Royal
Choice Of Colors : The Impressions
Cinnamon : Derek
Cloud Nine : Mongo Santamaria
Color Him Father : The Winstons
Come Together/Something : The Beatles
Crossroads : Cream
Crystal Blue Persuasion : Tommy James And The Shondells
Daddy's Little Man : O.C. Smith
Did You See Her Eyes : The Illusion
Do Your Thing : The Watts 103rd Street Rhythm Band
Don't Touch Me : Bettye Swann
Down On The Corner/Fortunate Son : Creedence Clearwater Revival
Early In The Morning : Vanity Fare
Echo Park : Keith Barbour
Eleanor Rigby : Aretha Franklin
Eli's Coming : Three Dog Night
Evil Woman Don't Play Your Games With Me : CROW
First Of May : Bee Gees
Friendship Train : Gladys Knight And The Pips
Games People Play : Joe South
Get Back : The Beatles With Billy Preston
Get Together : The Youngbloods
Gimme Gimme Good Lovin' : Crazy Elephant
Give Peace A Chance : Plastic Ono Band
Going In Circles : The Friends Of Distinction
Going Up The Country : Canned Heat
Goo Goo Barabajagal (Love Is Hot) : Donovan/Jeff Beck Group
Good Lovin' Ain't Easy To Come By : Marvin Gaye & Tammi Terrell
Good Old Rock 'N Roll : Cat Mother & the All Night News Boys
Goodbye : Mary Hopkin
Goodnight My Love : Paul Anka
Groovy Grubworm : Harlow Wilcox and the Oakies
Hair : The Cowsills
Happy Heart : Andy Williams
Hawaii Five-O : The Ventures
Heaven Knows : The Grass Roots
Here I Go Again : Smokey Robinson & The Miracles
Hey Jude : Wilson Pickett
Holly Holy : Neil Diamond
Honky Tonk Women : The Rolling Stones
Hot Fun In The Summertime : Sly & The Family Stone
Hot Smoke & Sasafrass : The Bubble Puppy
Hurt So Bad : The Lettermen
I Can Hear Music : The Beach Boys
I Can't Get Next To You : The Temptations
I Got A Line On You : Spirit
I Guess The Lord Must Be In New York City : Nilsson
I Love How You Love Me : Bobby Vinton
I Want You Back : Jackson 5
I'll Never Fall In Love Again : Tom Jones
I'll Try Something New : Supremes & Temptations
I'm A Better Man : Engelbert Humperdinck
I'm Gonna Make You Love Me : Diana Ross And The Supremes & The Temptations
I'm Gonna Make You Mine : Lou Christie
I've Gotta Be Me : Sammy Davis Jr.
In A Moment : The Intrigues
In The Year 2525 : Zager & Evans
Is That All There Is : Peggy Lee
Israelites : Desmond Dekker & The Aces
It's Getting Better : Mama Cass
It's Your Thing : The Isley Brothers
Jam Up Jelly Tight : Tommy Roe
Jealous Kind Of Fella : Garland Green
Jean : Oliver
Jesus Is A Soul Man : Lawrence Reynolds
Keem-O-Sabe : The Electric Indian
La La La (If I Had You) : Bobby Sherman
Lay Lady Lay : Bob Dylan
Leaving On A Jet Plane : Peter, Paul & Mary
Let It Be Me : Glen Campbell & Bobbie Gentry
Lo Mucho Que Te Quiero (The More I Love You) : Rene & Rene
Love (Can Make You Happy) : Mercy
Love Theme From Romeo & Juliet : Henry Mancini And His Orchestra
Love Will Find A Way : Jackie DeShannon
Make Believe : Wind
Make Your Own Kind Of Music : Mama Cass Elliot
Medicine Man (Part I) : Buchanan Brothers
Mendocino : Sir Douglas Quintet
Mercy : Ohio Express
Midnight Cowboy : Ferrante & Teicher
Mind, Body and Soul : The Flaming Ember
Moonflight : Vik Venus Alias: Your Main Moon Man
More Today Than Yesterday : Spiral Starecase
Morning Girl : The Neon Philharmonic
Move Over : Steppenwolf
Mr. Sun, Mr. Moon : Paul Revere & The Raiders Featuring Mark Lindsay
My Pledge Of Love : The Joe Jeffrey Group
My Way : Frank Sinatra
My Whole World Ended (The Moment You Left Me) : David Ruffin
Na Na Hey Hey Kiss Him Goodbye : Steam
No, Not Much : The Vogues
Nobody But You Babe : Clarence Reid
Nothing But A Heartache : The Flirtations
Oh Happy Day : The Edwin Hawkins' Singers Featuring: Dorothy Combs Morrison
Oh, What A Night : The Dells
Papa's Got A Brand New Bag : Otis Redding
Pinball Wizard : The Who
Polk Salad Annie : Tony Joe White
Quentin's Theme : The Charles Randolph Grean Sounde
Raindrops Keep Fallin' On My Head : B.J. Thomas
Ramblin' Gamblin' Man : Bob Seger System
Reconsider Me : Johnny Adams
Ruby, Don't Take Your Love To Town : Kenny Rogers & The First Edition
Scarborough Fair : Sergio Mendes & Brasil '66
Seattle : Perry Como
Smile A Little Smile For Me : The Flying Machine
Snatching It Back : Clarence Carter
So I Can Love You : The Emotions
Someday We'll Be Together : Diana Ross & The Supremes
Something In The Air : Thunderclap Newman
Sophisticated Cissy : The Meters
Soul Deep : The Box Tops
Soulful Strut : Young-Holt Unlimited
Soulshake : Peggy Scott & Jo Jo Benson
Special Delivery : 1910 Fruitgum Co.
Stand By Your Man : Tammy Wynette
Sugar On Sunday : The Clique
Sugar, Sugar : The Archies
Suite: Judy Blue Eyes : Crosby, Stills & Nash
Suspicious Minds : Elvis Presley
Take A Letter Maria : R.B. Greaves
That's The Way Love Is : Marvin Gaye
The April Fools : Dionne Warwick
The Beginning Of My End : The Unifics
The Boxer : Simon & Garfunkel
The Chokin' Kind : Joe Simon
The Letter : The Arbors
The Minotaur : Dick Hyman & His Electric Eclectics
There'll Come A Time : Betty Everett
There's Gonna Be A Showdown : Archie Bell & The Drells
These Eyes : Jr. Walker & The All Stars
Things I'd Like To Say : New Colony Six
This Girl Is A Woman Now : Gary Puckett And The Union Gap
This Magic Moment : Jay & The Americans
Time Is Tight : Booker T. & The MG's
Time Of The Season : The Zombies
Touch Me : The Doors
Traces : Classics IV Featuring Dennis Yost
Tracy : The Cuff Links
Try A Little Kindness : Glen Campbell
Twenty-Five Miles : Edwin Starr
Undun : The Guess Who
Up On Cripple Creek : The Band
Venus : The Shocking Blue
We Got More Soul : Dyke And The Blazers
Wedding Bell Blues : The 5th Dimension
What Kind Of Fool Do You Think I Am : Bill Deal & The Rhondels
What's The Use Of Breaking Up : Jerry Butler
When I Die : Motherlode
Who's Making Love : Johnnie Taylor
Whole Lotta Love : Led Zeppelin
Will You Be Staying After Sunday : The Peppermint Rainbow
With Pen In Hand : Vikki Carr
Wonderful World, Beautiful People : Jimmy Cliff
World (Part 1) : James Brown
Worst That Could Happen : Brooklyn Bridge
Yester-Me, Yester-You, Yesterday : Stevie Wonder
Yesterday, When I Was Young : Roy Clark
You Gave Me A Mountain : Frankie Laine
You Got Yours And I'll Get Mine : The Delfonics
You Showed Me : The Turtles
You, I : The Rugbys
Your Good Thing (Is About To End) : Lou Rawls
