(I Know) I'm Losing You : Rare Earth
(If You Let Me Make Love To You Then) Why Can't I Touch You? : Ronnie Dyson
25 Or 6 To 4 : Chicago
5-10-15-20 (25-30 Years Of Love) : The Presidents
A Brand New Me : Dusty Springfield
A Song Of Joy (Himno A La Alegria) : Miguel Rios
After Midnight : Eric Clapton
Ain't No Mountain High Enough : Diana Ross
Airport Love Theme (Gwen And Vern) : Vincent Bell
All I Have To Do Is Dream : Bobbie Gentry & Glen Campbell
All Right Now : Free
Always Something There To Remind Me : R.B. Greaves
Are You Ready? : Pacific Gas And Electric
Arizona : Mark Lindsay
As The Years Go By : Mashmakhan
Baby Take Me In Your Arms : Jefferson
Backfield In Motion : Mel And Tim
Be My Baby : Andy Kim
Big Yellow Taxi : The Neighborhood
Breaking Up Is Hard To Do : Lenny Welch
Call Me/Son Of A Preacher Man : Aretha Franklin
Candida : Dawn
Check Out Your Mind : The Impressions
Cherry Hill Park : Billy Joe Royal
Closer To Home (I'm Your Captain) : Grand Funk Railroad
Cold Turkey : Plastic Ono Band
Come And Get It : Badfinger
Come Running : Van Morrison
Come Saturday Morning : The Sandpipers
Cracklin' Rosie : Neil Diamond
Cry Me A River : Joe Cocker
Cupid : Johnny Nash
Deeper & Deeper : Freda Payne
Didn't I (Blow Your Mind This Time) : The Delfonics
Do The Funky Chicken : Rufus Thomas
Do What You Wanna Do : Five Flights Up
Don't Play That Song : Aretha Franklin with The Dixie Flyers
El Condor Pasa (If I Could) : Simon & Garfunkel
Engine Number 9 : Wilson Pickett
Everybody's Got The Right To Love : The Supremes
Everything Is Beautiful : Ray Stevens
Everything's Tuesday : Chairman Of The Board
Evil Ways : Santana
Evil Woman Don't Play Your Games With Me : CROW
Express Yourself : Charles Wright And The Watts 103rd Street Rhythm Band
Fancy : Bobbie Gentry
Fire And Rain : James Taylor
For The Good Times : Ray Price
For The Love Of Him : Bobbi Martin
Games : Redeye
Gimme Dat Ding : The Pipkins
Give Me Just A Little More Time : Chairmen Of The Board
Go Back : Crabby Appleton
God, Love And Rock & Roll : Teegarden & Van Winkle
Gotta Hold On To This Feeling : Jr. Walker & The All Stars
Green-Eyed Lady : Sugarloaf
Groove Me : King Floyd
Groovy Situation : Gene Chandler
Gypsy Woman : Brian Hyland
He Ain't Heavy, He's My Brother : The Hollies
Heaven Help Us All : Stevie Wonder
Heaven Knows : The Grass Roots
Heed The Call : Kenny Rogers & The First Edition
Hey Lawdy Mama : Steppenwolf
Hey There Lonely Girl : Eddie Holman
Hitchin' A Ride : Vanity Fare
House Of The Rising Sun : Frijid Pink
I (Who Have Nothing) : Tom Jones
I Am Somebody Part II : Johnnie Taylor
I Just Can't Help Believing : B.J. Thomas
I Think I Love You : The Partridge Family Starring Shirley Jones Featuring David Cassidy
I Want To Take You Higher : Ike & Tina Turner & The Ikettes
I'll Be There : Jackson 5
If I Were A Carpenter : Johnny Cash & June Carter
In The Summertime : Mungo Jerry
Indiana Wants Me : R. Dean Taylor
Instant Karma (We All Shine On) : John Ono Lennon
It Don't Matter To Me : Bread
It's A Shame : The Spinners
It's Impossible : Perry Como
It's Only Make Believe : Glen Campbell
Jam Up Jelly Tight : Tommy Roe
Jennifer Tomkins : Street People
Jingle Jangle : The Archies
Joanne : Michael Nesmith & The First National Band
Julie, Do Ya Love Me : Bobby Sherman
Lay A Little Lovin' On Me : Robin McNamara
Lay Down (Candles In The Rain) : Melanie with The Edwin Hawkins Singers
Leaving On A Jet Plane : Peter, Paul & Mary
Let It Be : The Beatles
Let Me Go To Him : Dionne Warwick
Let's Work Together (Part 1) : Wilbert Harrison
Let's Work Together : Canned Heat
Little Green Bag : George Baker Selection
Lola : The Kinks
Lonely Days : Bee Gees
Long Lonesome Highway : Michael Parks
Long Long Time : Linda Ronstadt
Look What They've Done To My Song Ma : The New Seekers featuring Eve Graham
Lookin' Out My Back Door/Long As I Can See The Light : Creedence Clearwater Revival
Love Grows (Where My Rosemary Goes) : Edison Lighthouse
Love On A Two-Way Street : The Moments
Love Or Let Me Be Lonely : The Friends Of Distinction
Love The One You're With : Stephen Stills
Lucretia Mac Evil : Blood, Sweat & Tears
Ma Belle Amie : The Tee Set
Maybe : The Three Degrees
Midnight Cowboy : Ferrante & Teicher
Mississippi : John Phillips
Mississippi Queen : Mountain
Montego Bay : Bobby Bloom
My Baby Loves Lovin' : White Plains
My Sweet Lord/Isn't It A Pity : George Harrison
Na Na Hey Hey Kiss Him Goodbye : Steam
Neanderthal Man : Hotlegs
O-o-h Child/Dear Prudence : The 5 Stairsteps
Oh Me Oh My (I'm A Fool For You Baby) : Lulu
One Tin Soldier : The Original Caste
Only Love Can Break Your Heart : Neil Young
Our House : Crosby, Stills, Nash & Young
Out In The Country : Three Dog Night
Overture From Tommy (A Rock Opera) : The Assembled Multitude
Patches : Clarence Carter
Peace Will Come (According To Plan) : Melanie
Psychedelic Shack : The Temptations
Puppet Man : The 5th Dimension
Question : The Moody Blues
Rainy Night In Georgia/Rubberneckin' : Brook Benton
Reflections Of My Life : The Marmalade
Ride Captain Ride : Blues Image
River Deep - Mountain High : The Supremes & Four Tops
Rose Garden : Lynn Anderson
Rubber Duckie : Ernie (Jim Henson)
See Me, Feel Me : The Who
Share The Land : The Guess Who
She : Tommy James And The Shondells
She Belongs To Me : Rick Nelson
Smile A Little Smile For Me : The Flying Machine
Snowbird : Anne Murray
Somebody's Been Sleeping : 100 Proof Aged in Soul
Someday We'll Be Together : Diana Ross & The Supremes
Spill The Wine : Eric Burdon And War
Spirit In The Sky : Norman Greenbaum
Stand By Your Man : Candi Staton
Still Water (Love) : Four Tops
Stoney End : Barbra Streisand
Super Bad (Part 1 & Part 2) : James Brown
Temma Harbour : Mary Hopkin
Tennessee Bird Walk : Jack Blanchard & Misty Morgan
Thank You Falettinme Be Mice Elf Agin/Everybody Is A Star : Sly & The Family Stone
The Bells : The Originals
The End Of Our Road : Marvin Gaye
The Letter : Joe Cocker with Leon Russell & The Shelter People
The Rapper : The Jaggerz
The Sly, Slick, And The Wicked : The Lost Generation
The Tears Of A Clown : Smokey Robinson & The Miracles
The Thrill Is Gone : B.B. King
Tighter, Tighter : Alive & Kicking
Turn Back The Hands Of Time : Tyrone Davis
United We Stand : The Brotherhood Of Man
Up On Cripple Creek : The Band
Vehicle : The Ides Of March
Venus : The Shocking Blue
Viva Tirado - Part I : El Chicano
Walk A Mile In My Shoes : Joe South and The Believers
Walkin' In The Rain : Jay & The Americans
War : Edwin Starr
We Gotta Get You A Woman : Runt
We've Only Just Begun : Carpenters
Westbound #9 : The Flaming Ember
What Is Truth : Johnny Cash
Which Way You Goin' Billy? : The Poppy Family (Featuring Susan Jacks)
Whole Lotta Love : Led Zeppelin
Winter World Of Love : Engelbert Humperdinck
Wonderful World, Beautiful People : Jimmy Cliff
Yellow River : Christie
You Don't Have To Say You Love Me/Patch It Up : Elvis Presley
You Need Love Like I Do (Don't You) : Gladys Knight And The Pips
You're The One-Part II : Little Sister
Your Song : Elton John
