(I Know) I'm Losing You : Rod Stewart With Faces
(If Loving You Is Wrong) I Don't Want To Be Right : Luther Ingram
A Cowboys Work Is Never Done : Sonny & Cher
Ain't Understanding Mellow : Jerry Butler & Brenda Lee Eager
Alive : Bee Gees
All The Young Dudes : Mott The Hoople
Amazing Grace : The Pipes And Drums And The Military Band Of The Royal Scots Dragoon Guards
American City Suite : Cashman & West
An American Trilogy : Mickey Newbury
Anticipation : Carly Simon
Ask Me What You Want : Millie Jackson
Baby Blue : Badfinger
Baby Don't Get Hooked On Me : Mac Davis
Baby Let Me Take You (In My Arms) : Detroit Emeralds
Back Off Boogaloo : Ringo Starr
Back Stabbers : The O'Jays
Bang A Gong (Get It On) : T. Rex
Beautiful Sunday : Daniel Boone
Ben : Michael Jackson
Betcha By Golly, Wow : The Stylistics Featuring Russell Thompkins,Jr.
Black & White : Three Dog Night
Black Dog : Led Zeppelin
Brand New Key : Melanie
Brandy (You're A Fine Girl) : Looking Glass
Breaking Up Is Hard To Do : The Partridge Family Starring Shirley Jones Featuring David Cassidy
Burning Love : Elvis Presley
Cherish : David Cassidy
Clair : Gilbert O'Sullivan
Clean Up Woman : Betty Wright
Conquistador : Procol Harum
Convention '72 : The Delegates
Corner Of The Sky : Jackson 5
Crazy Horses : The Osmonds
Crazy Mama : JJ Cale
Daddy Don't You Walk So Fast : Wayne Newton
Day By Day : Godspell
Day Dreaming : Aretha Franklin
Dialogue (Part I & II) : Chicago
Do It Again : Steely Dan
Doctor My Eyes : Jackson Browne
Don't Do It : The Band
Don't Let Me Be Lonely Tonight : James Taylor
Don't Say You Don't Remember : Beverly Bremers
Easy Livin : Uriah Heep
Every Day Of My Life : Bobby Vinton
Everybody Plays The Fool : The Main Ingredient
Feeling Alright : Joe Cocker
Fire And Water : Wilson Pickett
Floy Joy : The Supremes
Freddie's Dead (Theme From Superfly) : Curtis Mayfield
From The Beginning : Emerson, Lake & Palmer
Funny Face : Donna Fargo
Garden Party : Rick Nelson and The Stone Canyon Band
George Jackson : Bob Dylan
Geronimo's Cadillac : Michael Murphey
Get On The Good Foot-Part 1 : James Brown
Give Ireland Back To The Irish : Wings
Glory Bound : The Grass Roots
Go All The Way : Raspberries
Gone : Joey Heatherton
Good Time Charlie's Got The Blues : Danny O'Keefe
Goodbye To Love : Carpenters
Hallelujah : Sweathog
Happy : The Rolling Stones
Heart Of Gold : Neil Young
Help Me Make It Through The Night : Gladys Knight And The Pips
Hey Big Brother : Rare Earth
Hold Your Head Up : Argent
Honky Cat : Elton John
Hot Rod Lincoln : Commander Cody & His Lost Planet Airmen
How Do You Do? : Mouth & MacNeal
I Am Woman : Helen Reddy
I Believe In Music : Gallery
I Can See Clearly Now : Johnny Nash
I Can't Help Myself (Sugar Pie, Honey Bunch) : Donnie Elbert
I Didn't Know I Loved You (Till I Saw You Rock And Roll) : Gary Glitter
I Gotcha : Joe Tex
I Saw The Light : Todd Rundgren
I'd Like To Teach The World To Sing (In Perfect Harmony) : The Hillside Singers
I'd Like To Teach The World To Sing (In Perfect Harmony) : The New Seekers
I'd Love You To Want Me : Lobo
I'll Be Around/How Could I Let You Get Away : The Spinners
I'll Take You There : The Staple Singers
I'm Stone In Love With You : The Stylistics
I've Been Lonely For So Long : Frederick Knight
If I Could Reach You : The 5th Dimension
If You Don't Know Me By Now : Harold Melvin And The Blue Notes
If You Leave Me Tonight I'll Cry : Jerry Wallace
Immigration Man : Graham Nash & David Crosby
In The Rain : The Dramatics
It Never Rains In Southern California : Albert Hammond
Join Together : The Who
Joy : Apollo featuring Tom Parker
Jump Into The Fire : Nilsson
Jungle Fever : The Chakachas
Keeper Of The Castle : Four Tops
Kiss An Angel Good Mornin' : Charley Pride
Layla : Derek & The Dominos
Listen To The Music : The Doobie Brothers
Living In The Past : Jethro Tull
Long Dark Road : The Hollies
Long Haired Lover From Liverpool : Little Jimmy Osmond with The Mike Curb Congregation
Looking For A Love : The J. Geils Band
Love Theme From The Godfather (Speak Softly Love) : Andy Williams
Loving You Just Crossed My Mind : Sam Neely
Me And Bobby McGee : Jerry Lee Lewis
Me And Mrs. Jones : Billy Paul
Midnight Rider : Joe Cocker and The Chris Stainton Band
Mister Can't You See : Buffy Sainte-Marie
Mother And Child Reunion : Paul Simon
Motorcycle Mama : Sailcat
My Ding-A-Ling : Chuck Berry
Nights In White Satin : The Moody Blues
No One To Depend On : Santana
Oh Girl : The Chi-lites
Oh, Babe, What Would You Say? : Hurricane Smith
Once You Understand : Think
Operator (That's Not the Way it Feels) : Jim Croce
Outa-Space : Billy Preston
Papa Was A Rollin' Stone : The Temptations
Pop That Thang : The Isley Brothers
Popcorn : Hot Butter
Power Of Love : Joe Simon
Precious And Few : Climax
Rock 'N Roll Soul : Grand Funk Railroad
Rock And Roll Lullaby : B.J. Thomas
Rockin' Pneumonia - Boogie Woogie Flu : Johnny Rivers
Roundabout : Yes
Run Run Run : Jo Jo Gunne
Runnin' Away : Sly & The Family Stone
School's Out : Alice Cooper
Sitting : Cat Stevens
Slippin' Into Darkness : War
Small Beginnings : Flash
Smoke Gets In Your Eyes : Blue Haze
Softly Whispering I Love You : The English Congregation
Someday Never Comes : Creedence Clearwater Revival
Something's Wrong With Me : Austin Roberts
Speak To The Sky : Rick Springfield
Starting All Over Again : Mel And Tim
Stay With Me : Faces
Suavecito : Malo
Summer Breeze : Seals & Crofts
Sunny Days : Lighthouse
Sunshine : Jonathan Edwards
Superstition : Stevie Wonder
Sweet Inspiration/Where You Lead : Barbra Streisand
Sweet Seasons : Carole King
Sweet Surrender : Bread
Sylvia's Mother : Dr. Hook And The Medicine Show
Taurus : Dennis Coffey & The Detroit Guitar Band
Taxi : Harry Chapin
That's The Way I Feel About Cha : Bobby Womack & Peace
The Candy Man : Sammy Davis, Jr. with The Mike Curb Congregation
The City Of New Orleans : Arlo Guthrie
The Day I Found Myself : The Honey Cone
The First Time Ever I Saw Your Face : Roberta Flack
The Lion Sleeps Tonight : Robert John
The Way Of Love : Cher
The Witch Queen Of New Orleans : Redbone
Theme From Summer Of '42 : Peter Nero
Theme From The Men : Isaac Hayes
Thunder And Lightning : Chi Coltrane
Tight Rope : Leon Russell
Too Late To Turn Back Now : Cornelius Brothers & Sister Rose
Troglodyte (Cave Man) : The Jimmy Castor Bunch
Trouble Man : Marvin Gaye
Use Me : Bill Withers
Ventura Highway : America
Vincent (Starry, Starry Night)/Castles In The Air : Don McLean
Walk On Water : Neil Diamond
Walkin' In The Rain With The One I Love : Love Unlimited
We've Got To Get It On Again : Addrisi Brothers
What Am I Crying For? : Dennis Yost And The Classics IV
Where Is The Love : Roberta Flack & Donny Hathaway
White Lies, Blue Eyes : Bullet
Why Can't We Live Together : Timmy Thomas
Why/Lonely Boy : Donny Osmond
Witchy Woman : Eagles
You Could Have Been A Lady : April Wine
You Ought To Be With Me : Al Green
You Turn Me On, I'm A Radio : Joni Mitchell
You Wear It Well : Rod Stewart
You're Still A Young Man : Tower Of Power
Your Mama Don't Dance : Kenny Loggins & Jim Messina
