#9 Dream : John Lennon
(Hey Won't You Play) Another Somebody Done Somebody Wrong Song : B.J. Thomas
(I Believe) There's Nothing Stronger Than Our Love : Paul Anka/Odia Coates
(Shu-Doo-Pa-Poo-Poop) Love Being Your Fool : Travis Wammack
Ain't No Way To Treat A Lady : Helen Reddy
Amie : Pure Prairie League
At Seventeen : Janis Ian
Attitude Dancing : Carly Simon
Autobahn : Kraftwerk
Baby Face : The Wing And A Prayer Fife & Drum Corps.
Baby That's Backatcha : Smokey Robinson
Bad Blood : Neil Sedaka
Bad Luck (Part 1) : Harold Melvin And The Blue Notes
Ballroom Blitz : Sweet
Beer Barrel Polka/Dick And Jane : Bobby Vinton
Big Yellow Taxi : Joni Mitchell
Black Friday : Steely Dan
Black Superman - Muhammad Ali : Johnny Wakelin & The Kinshasa Band
Black Water : The Doobie Brothers
Bloody Well Right : Supertramp
Blue Eyes Crying In The Rain : Willie Nelson
Boogie On Reggae Woman : Stevie Wonder
Born To Run : Bruce Springsteen
Brazil : The Ritchie Family
Bungle In The Jungle : Jethro Tull
Butter Boy : Fanny
Can't Get It Out Of My Head : Electric Light Orchestra
Carolina In The Pines : Michael Murphey
Cat's In The Cradle : Harry Chapin
Chevy Van : Sammy Johns
Could It Be Magic : Barry Manilow
Dance With Me : Orleans
Dancin' Fool : The Guess Who
Dark Horse : George Harrison
Diamonds And Rust : Joan Baez
Do It Any Way You Wanna : Peoples Choice
Doctor's Orders : Carol Douglas
Don't Call Us, We'll Call You : Sugarloaf/Jerry Corbetta
Don't Take Your Love : The Manhattans
Don't Tell Me Goodnight : Lobo
Dream Merchant : New Birth
Dynomite-Part I : Tony Camillo's Bazuka
Eighteen With A Bullet : Pete Wingfield
Every Time You Touch Me (I Get High) : Charlie Rich
Express : B.T. Express
Fallin' In Love : Hamilton, Joe Frank & Reynolds
Fame : David Bowie
Feel Like Makin' Love : Bad Company
Feelings : Morris Albert
Fight The Power Part 1 : The Isley Brothers
Fire : Ohio Players
Fire On The Mountain : The Marshall Tucker Band
Fly, Robin, Fly : Silver Convention
Free Bird : Lynyrd Skynyrd
From His Woman To You : Barbara Mason
Full Of Fire : Al Green
Get Dancin' : Disco Tex & The Sex-O-Lettes
Get Down, Get Down (Get On The Floor) : Joe Simon
Gone At Last : Paul Simon/Phoebe Snow
Harry Truman : Chicago
Have You Never Been Mellow : Olivia Newton-John
Heat Wave/love Is A Rose : Linda Ronstadt
Help Me Rhonda : Johnny Rivers
Hijack : Herbie Mann
Holdin' On To Yesterday : Ambrosia
How Long (Betcha' Got A Chick On The Side) : The Pointer Sisters
How Long : Ace
How Sweet It Is (To Be Loved By You) : James Taylor
I Am Love (Parts I & II) : Jackson 5
I Belong To You : Love Unlimited
I Can Help : Billy Swan
I Don't Like To Sleep Alone : Paul Anka with Odia Coates
I Get Lifted : George McCrae
I Got Stoned And I Missed It : Jim Stafford
I Love Music (Part 1) : The O'Jays
I Only Have Eyes For You : Art Garfunkel
I Want'a Do Something Freaky To You : Leon Haywood
I'll Play For You : Seals & Crofts
I'm A Woman : Maria Muldaur
I'm Not In Love : 10cc
I'm Not Lisa : Jessi Colter
I'm On Fire : 5000 Volts
I'm On Fire : Dwight Twilley Band
I'm Sorry : John Denver
I've Been This Way Before : Neil Diamond
If I Ever Lose This Heaven : AWB
Island Girl : Elton John
It Only Takes A Minute : Tavares
Jackie Blue : Ozark Mountain Daredevils
Judy Mae : Boomer Castleman
Junior's Farm/Sally G : Paul McCartney & Wings
Just A Little Bit Of You : Michael Jackson
KILLER QUEEN : Queen
Kung Fu Fighting : Carl Douglas
Lady : Styx
Lady Blue : Leon Russell
Lady Marmalade : Labelle
Let's Do It Again : The Staple Singers
Let's Live Together : The Road Apples
Lizzie And The Rainman : Tanya Tucker
Lonely People : America
Long Tall Glasses (I Can Dance) : Leo Sayer
Look At Me (I'm In Love) : Moments
Love Machine (Part 1) : The Miracles
Love To Love You Baby : Donna Summer
Love Won't Let Me Wait : Major Harris
Lovin' You : Minnie Riperton
Low Rider : War
Lyin' Eyes : Eagles
Magic : Pilot
Main Title (Theme From Jaws) : John Williams/Jaws Soundtrack
Midnight Blue : Melissa Manchester
Miracles : Jefferson Starship
Misty : Ray Stevens
Morning Side Of The Mountain : Donny & Marie Osmond
Mr. Jaws : Dickie Goodman
Must Of Got Lost : The J. Geils Band
My Boy : Elvis Presley
My Eyes Adored You : Frankie Valli
My Little Town : Simon & Garfunkel
Never Can Say Goodbye : Gloria Gaynor
Never Let Her Go : David Gates
Nightingale : Carole King
Nights On Broadway : Bee Gees
No No Song/snookeroo : Ringo Starr
Once You Get Started : Rufus Featuring Chaka Khan
Only Women : Alice Cooper
Operator : The Manhattan Transfer
Over My Head : Fleetwood Mac
Part Of The Plan : Dan Fogelberg
Part Time Love : Gladys Knight And The Pips
Philadelphia Freedom : The Elton John Band
Poetry Man : Phoebe Snow
Rainy Day People : Gordon Lightfoot
Rendezvous : The Hudson Brothers
Rhinestone Cowboy : Glen Campbell
Ride 'em Cowboy : Paul Davis
Rock And Roll All Nite (live) : Kiss
Rock N' Roll (I Gave You The Best Years Of My Life) : Mac Davis
Rockin' All Over The World : John Fogerty
Rockin' Chair : Gwen McCrae
Rocky : Austin Roberts
Roll On Down The Highway : Bachman-Turner Overdrive
Ruby, Baby : Billy Crash Craddock
Run Joey Run : David Geddes
S.O.S. : ABBA
Sad Sweet Dreamer : Sweet Sensation
Satin Soul : Love Unlimited Orchestra
Saturday Night : Bay City Rollers
Send In The Clowns : Judy Collins
Shakey Ground : The Temptations
Shame, Shame, Shame : Shirley And Company
Shaving Cream : Benny Bell
Shoeshine Boy : Eddie Kendricks
Sky High : Jigsaw
Slippery When Wet : Commodores
Solitaire : Carpenters
Some Kind Of Wonderful : Grand Funk
Spirit Of The Boogie/Summer Madness : Kool & The Gang
Struttin' : Billy Preston
Supernatural Thing - Part I : Ben E. King
Sweet Emotion : Aerosmith
Tangled Up In Blue : Bob Dylan
That's The Way (I Like It) : KC And The Sunshine Band
That's The Way Of The World : Earth, Wind & Fire
The Bertha Butt Boogie-Part 1 : The Jimmy Castor Bunch
The Entertainer : Billy Joel
The Hustle : Van McCoy The Soul City Symphony
The Last Farewell : Roger Whittaker
The Proud One : The Osmonds
The Rockford Files : Mike Post
The South's Gonna Do It : The Charlie Daniels Band
The Way I Want To Touch You : Captain & Tennille
Theme From Mahogany (Do You Know Where You're Going To) : Diana Ross
There Goes Another Love Song : The Outlaws
They Just Can't Stop It the (Games People Play) : The Spinners
Third Rate Romance : Amazing Rhythm Aces
This Will Be : Natalie Cole
Til The World Ends : Three Dog Night
Times Of Your Life : Paul Anka
To The Door Of The Sun (Alle Porte Del Sole) : Al Martino
Trampled Under Foot : Led Zeppelin
Tush : ZZ Top
Two Fine People : Cat Stevens
Up In A Puff Of Smoke : Polly Brown
Venus And Mars Rock Show : Wings
Walk Away From Love : David Ruffin
Walking In Rhythm : The Blackbyrds
Wasted Days And Wasted Nights : Freddy Fender
What A Diff'rence A Day Makes : Esther Phillips
What Am I Gonna Do With You : Barry White
When Will I See You Again : The Three Degrees
Who Loves You : The 4 Seasons
Who's Sorry Now : Marie Osmond
Wolf Creek Pass : C.W. McCall
You Are So Beautiful/It's A Sin When You Love Somebody : Joe Cocker
You Sexy Thing : Hot Chocolate
You're All I Need To Get By : Tony Orlando & Dawn
Your Love : Graham Central Station
