(Every Time I Turn Around) Back In Love Again : LTD
(Our Love) Don't Throw It All Away : Andy Gibb
(What A) Wonderful World : Art Garfunkel With James Taylor & Paul Simon
5.7.0.5. : City Boy
A Rock 'N' Roll Fantasy : The Kinks
Alive Again : Chicago
Almost Like Being In Love : Michael Johnson
Almost Summer : Celebration featuring Mike Love
As : Stevie Wonder
Baby Hold On : Eddie Money
Because The Night : Patti Smith Group
Blue Collar Man (Long Nights) : Styx
Boogie Oogie Oogie : A Taste Of Honey
Boogie Shoes : KC And The Sunshine Band
Breakdown : Tom Petty And The Heartbreakers
Can We Still Be Friends : Todd Rundgren
Can You Fool : Glen Campbell
Change Of Heart : Eric Carmen
Chattanooga Choo Choo : Tuxedo Junction
Cheeseburger In Paradise : Jimmy Buffett
Close The Door : Teddy Pendergrass
Come Together : Aerosmith
Count On Me : Jefferson Starship
Dance (Disco Heat) : Sylvester
Dance Across The Floor : Jimmy Bo Horne
Dance With Me : Peter Brown with Betty Wright
DesirÃ©e : Neil Diamond
Devoted To You : Carly Simon & James Taylor
Disco Inferno : The Trammps
Do You Believe In Magic : Shaun Cassidy
Don't Hold Back : Chanson
Don't Let Me Be Misunderstood : Santa Esmeralda Starring Leroy Gomez
Don't Look Back : Boston
Don't Want To Live Without It : Pablo Cruise
Double Vision : Foreigner
Dust In The Wind : Kansas
Easy To Love : Leo Sayer
Ebony Eyes : Bob Welch
Emotion : Samantha Sang
Every 1's A Winner : Hot Chocolate
Every Kinda People : Robert Palmer
Everybody Needs Love : Stephen Bishop
Falling : LeBlanc & Carr
Fantasy : Earth, Wind & Fire
Feels So Good : Chuck Mangione
Ffun : Con Funk Shun
Fire : The Pointer Sisters
Flash Light : Parliament
Follow You Follow Me : Genesis
Fool If You Think It's Over : Chris Rea
Galaxy : War
Get Off : Foxy
Gettin' Ready For Love : Diana Ross
Goodbye Girl : David Gates
Grease : Frankie Valli
Hold The Line : Toto
Hopelessly Devoted To You : Olivia Newton-John
Hot Child In The City : Nick Gilder
How Much I Feel : Ambrosia
How You Gonna See Me Now : Alice Cooper
I Can't Stand The Rain : Eruption
I Just Wanna Stop : Gino Vannelli
I Love The Nightlife (Disco 'Round) : Alicia Bridges
I Will Be In Love With You : Livingston Taylor
I Will Still Love You : Stonebolt
I'm Every Woman : Chaka Khan
I'm Gonna Take Care Of Everything : Rubicon
If Ever I See You Again : Roberta Flack
If I Can't Have You : Yvonne Elliman
Imaginary Lover : Atlanta Rhythm Section
Instant Replay : Dan Hartman
Isn't It Time : The Babys
It's A Heartache : Bonnie Tyler
It's A Laugh : Daryl Hall John Oates
It's You That I Need : Enchantment
Jack And Jill : Raydio
Just What I Needed : The Cars
King Tut : Steve Martin and the Toot Uncommons
Kiss You All Over : Exile
Lady Love : Lou Rawls
Lay Down Sally : Eric Clapton
Le Freak : Chic
Let's All Chant : The Michael Zager Band
Life's Been Good : Joe Walsh
Like A Sunday In Salem (The Amos & Andy Song) : Gene Cotton
Lotta Love : Nicolette Larson
Love Is In The Air : John Paul Young
Love Is Like Oxygen : Sweet
Love Theme From Eyes Of Laura Mars (Prisoner) : Barbra Streisand
Lovely Day : Bill Withers
MacArthur Park : Donna Summer
Magnet And Steel : Walter Egan
Miss You : The Rolling Stones
More Than A Woman : Tavares
My Angel Baby : Toby Beau
My Life : Billy Joel
My Way : Elvis Presley
Native New Yorker : Odyssey
New York Groove : Ace Frehley
Oh What A Night For Dancing : Barry White
Oh! Darling : Robin Gibb
On Broadway : George Benson
On The Shelf : Donny & Marie Osmond
One Nation Under A Groove - Part I : Funkadelic
Ooh Baby Baby : Linda Ronstadt
Our Love : Natalie Cole
Paradise By The Dashboard Light : Meat Loaf
Part-Time Love : Elton John
Peg : Steely Dan
Please Come Home For Christmas : Eagles
Promises : Eric Clapton And His Band
Prove It All Night : Bruce Springsteen
Ready To Take A Chance Again : Barry Manilow
Reminiscing : Little River Band
Right Down The Line : Gerry Rafferty
Rivers Of Babylon : Boney M
Rocket Ride : Kiss
Run For Home : Lindisfarne
Runaround Sue : Leif Garrett
Running On Empty : Jackson Browne
Shake It : Ian Matthews
Shame : Evelyn Champagne King
Sharing The Night Together : Dr. Hook
Short People : Randy Newman
Slip Slidin' Away : Paul Simon
Sometimes When We Touch : Dan Hill
Stay : Rufus/Chaka Khan
Steppin' In A Slide Zone : The Moody Blues
Stone Blue : Foghat
Straight On : Heart
Strange Way : Firefall
Street Corner Serenade : Wet Willie
Stuff Like That : Quincy Jones
Summer Nights : John Travolta & Olivia Newton-John & Cast
Sweet Life : Paul Davis
Sweet Talkin' Woman : Electric Light Orchestra
Swingtown : The Steve Miller Band
Take Me To The River : Talking Heads
Talking In Your Sleep : Crystal Gayle
Thank God It's Friday : Love And Kisses
Thank You For Being A Friend : Andrew Gold
The Circle Is Small (I Can See It In Your Eyes) : Gordon Lightfoot
The Closer I Get To You : Roberta Flack with Donny Hathaway
The Gambler : Kenny Rogers
The Groove Line : Heatwave
The Name Of The Game : ABBA
The Power Of Gold : Dan Fogelberg/Tim Weisberg
The Way I Feel Tonight : Bay City Rollers
Theme From Close Encounters : Meco
Theme From Close Encounters Of The Third Kind : John Williams
Theme Song From Which Way Is Up : Stargard
There'll Never Be : Switch
Think It Over : Cheryl Ladd
This Is Love : Paul Anka
This Time I'm In It For Love : Player
Three Times A Lady : Commodores
Thunder Island : Jay Ferguson
Time Passages : Al Stewart
Too Much Heaven : Bee Gees
Too Much, Too Little, Too Late : Johnny Mathis/Deniece Williams
Two Doors Down : Dolly Parton
Use Ta Be My Girl : The O'Jays
Warm Ride : Rare Earth
We Will Rock You/We Are The Champions : Queen
We'll Never Have To Say Goodbye Again : England Dan & John Ford Coley
We've Got Tonight : Bob Seger & The Silver Bullet Band
Werewolves Of London : Warren Zevon
What's Your Name : Lynyrd Skynyrd
Whenever I Call You Friend : Kenny Loggins
Who Are You : The Who
Will You Still Love Me Tomorrow : Dave Mason
With A Little Luck : Wings
Y.M.C.A. : Village People
You : Rita Coolidge
You And I : Rick James
You Belong To Me : Carly Simon
You Can't Turn Me Off (In The Middle Of Turning Me On) : High Inergy
You Don't Bring Me Flowers : Barbra Streisand & Neil Diamond
You Light Up My Life : Debby Boone
You Needed Me : Anne Murray
You Never Done It Like That : Captain & Tennille
You Really Got Me : Van Halen
You're A Part Of Me : Gene Cotton With Kim Carnes
You're In My Heart (The Final Acclaim) : Rod Stewart
You're The Love : Seals & Crofts
You're The One That I Want : John Travolta & Olivia Newton-John
