(If Loving You Is Wrong) I Don't Want To Be Right : Barbara Mandrell
(Our Love) Don't Throw It All Away : Andy Gibb
A Man I'll Never Be : Boston
Ain't Love A Bitch : Rod Stewart
Ain't No Stoppin' Us Now : McFadden & Whitehead
Baby I'm Burnin' : Dolly Parton
Bad Case Of Loving You (Doctor, Doctor) : Robert Palmer
Bicycle Race/Fat Bottomed Girls : Queen
Blow Away : George Harrison
Blue Morning, Blue Day : Foreigner
Boogie Wonderland : Earth, Wind & Fire with The Emotions
Born To Be Alive : Patrick Hernandez
Bustin' Loose Part 1 : Chuck Brown & The Soul Searchers
Chase : Giorgio Moroder
Chiquitita : ABBA
Chuck E.'s In Love : Rickie Lee Jones
Come To Me : France Joli
Crazy Love : Poco
Crazy Love : The Allman Brothers Band
Cruel To Be Kind : Nick Lowe
Cruisin' : Smokey Robinson
Damned If I Do : The Alan Parsons Project
Dance The Night Away : Van Halen
Deeper Than The Night : Olivia Newton-John
Different Worlds : Maureen McGovern
Disco Nights (Rock-Freak) : G.Q.
Do That To Me One More Time : Captain & Tennille
Dog + Butterfly : Heart
Don't Cry Out Loud : Melissa Manchester
Don't Do Me Like That : Tom Petty And The Heartbreakers
Don't Ever Wanna Lose Ya : New England
Don't Hold Back : Chanson
Don't Let Go : Isaac Hayes
Don't Stop 'Til You Get Enough : Michael Jackson
Don't You Write Her Off : McGuinn, Clark & Hillman
Driver's Seat : Sniff 'n' the Tears
Escape (The Pina Colada Song) : Rupert Holmes
Every 1's A Winner : Hot Chocolate
Every Time I Think Of You : The Babys
Every Which Way But Loose : Eddie Rabbitt
Fins : Jimmy Buffett
Fire : The Pointer Sisters
Forever In Blue Jeans : Neil Diamond
Found A Cure : Ashford & Simpson
Get Used To It : Roger Voudouris
Girl Of My Dreams : Bram Tchaikovsky
Gold : John Stewart
Good Friend : Mary Macgregor
Good Timin' : The Beach Boys
Goodnight Tonight : Wings
Got To Be Real : Cheryl Lynn
Gotta Serve Somebody : Bob Dylan
Half The Way : Crystal Gayle
Haven't Stopped Dancing Yet : Gonzalez
Heart Of Glass : Blondie
Heartache Tonight : Eagles
Heaven Knows : Donna Summer with Brooklyn Dreams
Heaven Must Have Sent You : Bonnie Pointer
Highway Song : Blackfoot
Hold On : Ian Gomm
Hold On : Triumph
Hold The Line : Toto
Home And Dry : Gerry Rafferty
Honesty : Billy Joel
Hot Number : Foxy
Hot Stuff : Donna Summer
Hot Summer Nights : Night
How You Gonna See Me Now : Alice Cooper
I Can't Stand It No More : Peter Frampton
I Do Love You : GQ
I Don't Know If It's Right : Evelyn Champagne King
I Got My Mind Made Up (You Can Get It Girl) : Instant Funk
I Just Fall In Love Again : Anne Murray
I Just Wanna Stop : Gino Vannelli
I Know A Heartache When I See One : Jennifer Warnes
I Love The Nightlife (Disco 'Round) : Alicia Bridges
I Need A Lover : John Cougar
I Still Have Dreams : Richie Furay
I Wanna Be Your Lover : Prince
I Want You To Want Me : Cheap Trick
I Want You Tonight : Pablo Cruise
I Was Made For Dancin' : Leif Garrett
I Was Made For Lovin' You : Kiss
I Will Be In Love With You : Livingston Taylor
I Will Survive : Gloria Gaynor
I'll Never Love This Way Again : Dionne Warwick
I'm Every Woman : Chaka Khan
If I Said You Have A Beautiful Body Would You Hold It Against Me : Bellamy Brothers
If You Remember Me : Chris Thompson & Night
If You Want It : Niteflyte
In The Navy : Village People
Instant Replay : Dan Hartman
Is She Really Going Out With Him? : Joe Jackson
It Must Be Love : Alton McClain & Destiny
Jane : Jefferson Starship
Just When I Needed You Most : Randy Vanwarmer
Kiss In The Dark : Pink Lady
Knock On Wood : Amii Stewart
Ladies Night : Kool & The Gang
Lady : Little River Band
Le Freak : Chic
Lead Me On : Maxine Nightingale
Let's Go : The Cars
Little Bit Of Soap : Nigel Olsson
Livin' It Up (Friday Night) : Bell & James
Lotta Love : Nicolette Larson
Love Ballad : George Benson
Love Don't Live Here Anymore : Rose Royce
Love Is The Answer : England Dan & John Ford Coley
Love Pains : Yvonne Elliman
Love Takes Time : Orleans
Love You Inside Out : Bee Gees
Lovin', Touchin', Squeezin' : Journey
Makin' It : David Naughton
Married Men : Bette Midler
Maybe I'm A Fool : Eddie Money
Minute By Minute : The Doobie Brothers
Morning Dance : Spyro Gyra
Music Box Dancer : Frank Mills
My Sharona : The Knack
New York Groove : Ace Frehley
No More Tears (Enough Is Enough) : Barbra Streisand/Donna Summer
No Tell Lover : Chicago
Oh Well : Rockets
Old Time Rock & Roll : Bob Seger & The Silver Bullet Band
One Last Kiss : The J. Geils Band
Ooh Baby Baby : Linda Ronstadt
People Of The South Wind : Kansas
Please Don't Go : KC And The Sunshine Band
Please Don't Leave : Lauren Wood
Pop Muzik : M
Precious Love : Bob Welch
Rainbow Connection : Kermit (Jim Henson)
Renegade : Styx
Reunited : Peaches & Herb
Ring My Bell : Anita Ward
Rise : Herb Alpert
Rock 'n' Roll Fantasy : Bad Company
Rolene : Moon Martin
Roller : April Wine
Roxanne : The Police
Sad Eyes : Robert John
Sail On : Commodores
Saturday Night, Sunday Morning : Thelma Houston
Saturdaynight : Herman Brood
Send One Your Love : Stevie Wonder
September : Earth, Wind & Fire
Shake It : Ian Matthews
Shake Your Body (Down To The Ground) : The Jacksons
Shakedown Cruise : Jay Ferguson
Shattered : The Rolling Stones
She Believes In Me : Kenny Rogers
Shine A Little Love : Electric Light Orchestra
So Good, So Right : Brenda Russell
Somewhere In The Night : Barry Manilow
Song On The Radio : Al Stewart
Soul Man : Blues Brothers
Spooky : Atlanta Rhythm Section
Stormy : Santana
Street Life : The Crusaders
Stumblin' In : Suzi Quatro & Chris Norman
Such A Woman : Tycoon
Sultans Of Swing : Dire Straits
Superman : Herbie Mann
Sweet Lui-Louise : Ironhorse
TUSK : Fleetwood Mac
Take Me Home : Cher
Take Me To The River : Talking Heads
The Boss : Diana Ross
The Devil Went Down To Georgia : The Charlie Daniels Band
The Logical Song : Supertramp
The Main Event/Fight : Barbra Streisand
Third Time Lucky (First Time I Was A Fool) : Foghat
This Is It : Kenny Loggins
This Night Won't Last Forever : Michael Johnson
Up On The Roof : James Taylor
Victim Of Love : Elton John
Video Killed The Radio Star : The Buggles
Wait For Me : Daryl Hall John Oates
Watch Out For Lucy : Eric Clapton And His Band
We Are Family : Sister Sledge
We Don't Talk Anymore : Cliff Richard
Weekend : Wet Willie
What Cha Gonna Do With My Lovin' : Stephanie Mills
What You Won't Do For Love : Bobby Caldwell
When You're In Love With A Beautiful Woman : Dr. Hook
Where Were You When I Was Falling In Love : Lobo
Yes, I'm Ready : Teri DeSario With K.C.
You Can Do It : Dobie Gray
You Can't Change That : Raydio
You Don't Bring Me Flowers : Barbra Streisand & Neil Diamond
You Gonna Make Me Love Somebody Else : The Jones Girls
You Make Me Feel (Mighty Real) : Sylvester
You Take My Breath Away : Rex Smith
You Thrill Me : Exile
You Took The Words Right Out Of My Mouth : Meat Loaf
You're Only Lonely : J.D.Souther
