(Pride) In The Name Of Love : U2
(what) In The Name Of Love : Naked Eyes
10-9-8 : Face To Face
17 : Rick James
99 Luftballons : Nena
A Fine Fine Day : Tony Carey
A Girl In Trouble (Is A Temporary Thing) : Romeo Void
Against All Odds (Take A Look At Me Now) : Phil Collins
Alibis : Sergio Mendes
All I Need : Jack Wagner
All Of You : Julio Iglesias & Diana Ross
Almost Paradise...Love Theme From Footloose : Mike Reno And Ann Wilson
Are We Ourselves? : The Fixx
Baby I Lied : Deborah Allen
Bang Your Head (Metal Health) : Quiet Riot
Blue Jean : David Bowie
Borderline : Madonna
Boys Do Fall In Love : Robin Gibb
Break My Stride : Matthew Wilder
Breakdance : Irene Cara
Breakin'...there's No Stopping Us : Ollie And Jerry
Careless Whisper : Wham! Featuring George Michael
Caribbean Queen (No More Love On The Run) : Billy Ocean
Centipede : Rebbie Jackson
Come Back And Stay : Paul Young
Cool It Now : New Edition
Cruel Summer : Bananarama
Dance Hall Days : Wang Chung
Dancing In The Dark : Bruce Springsteen
Dancing In The Sheets : Shalamar
Desert Moon : Dennis DeYoung
Don't Answer Me : The Alan Parsons Project
Dynamite : Jermaine Jackson
Easy Lover : Philip Bailey With Phil Collins
Eat It : Weird Al Yankovic
Eyes Without A Face : Billy Idol
Footloose : Kenny Loggins
Girls : Dwight Twilley
Girls With Guns : Tommy Shaw
Give It Up : KC
Go Insane : Lindsey Buckingham
Head Over Heels : Go-Go's
Hello : Lionel Richie
Hold Me Now : Thompson Twins
Holding Out For A Hero : Bonnie Tyler
I Can Dream About You : Dan Hartman
I Can't Drive 55 : Sammy Hagar
I Can't Hold Back : Survivor
I Do'wanna Know : REO Speedwagon
I Feel For You : Chaka Khan
I Just Called To Say I Love You : Stevie Wonder
I Still Can't Get Over Loving You : Ray Parker Jr.
I Want To Know What Love Is : Foreigner
I'll Wait : Van Halen
If Ever You're In My Arms Again : Peabo Bryson
If I'd Been The One : Thirty Eight Special
In A Big Country : Big Country
In The Mood : Robert Plant
Infatuation : Rod Stewart
Islands In The Stream : Kenny Rogers with Dolly Parton
It Ain't Enough : Corey Hart
It's A Miracle : Culture Club
It's My Life : Talk Talk
Joanna : Kool & The Gang
Jump (for My Love) : The Pointer Sisters
Legs : ZZ Top
Let The Music Play : Shannon
Let's Go Crazy : Prince And The Revolution
Let's Hear It For The Boy : Deniece Williams
Lights Out : Peter Wolf
Livin' In Desperate Times : Olivia Newton-John
Love Somebody : Rick Springfield
Love Will Show Us How : Christine McVie
Major Tom (Coming Home) : Peter Schilling
Middle Of The Road : Pretenders
Missing You : John Waite
Modern Day Delilah : Van Stephenson
Music Time : Styx
My Ever Changing Moods : The Style Council
Nightbird : Stevie Nicks
No More Words : Berlin
No Way Out : Jefferson Starship
Nobody Told Me : John Lennon
On The Dark Side : John Cafferty & The Beaver Brown Band
Only When You Leave : Spandau Ballet
Out Of Touch : Daryl Hall John Oates
Owner Of A Lonely Heart : Yes
Pink Houses : John Mellencamp
Radio Ga-ga : Queen
Read 'Em And Weep : Barry Manilow
Red Red Wine : UB40
Remember The Night : The Motels
Rock Me Tonite : Billy Squier
Rock You Like A Hurricane : Scorpions
Romancing The Stone : Eddy Grant
Round and Round : Ratt
Run To You : Bryan Adams
Run, Runaway : Slade
Runaway : Bon Jovi
Runner : Manfred Mann's Earth Band
Say Say Say : Paul McCartney And Michael Jackson
Sea Of Love : The Honeydrippers
Self Control : Laura Branigan
Send Me An Angel : Real Life
Sexy Girl : Glenn Frey
She's Mine : Steve Perry
Shine Shine : Barry Gibb
Sister Christian : Night Ranger
So Bad : Paul McCartney
Somebody's Watching Me : Rockwell
Stay The Night : Chicago
Stay With Me Tonight : Jeffrey Osborne
Stranger In Town : Toto
Strut : Sheena Easton
Sugar Don't Bite : Sam Harris
Swept Away : Diana Ross
Talking In Your Sleep : The Romantics
Teacher Teacher : 38 Special
That's All : Genesis
The Authority Song : John Cougar Mellencamp
The Boys Of Summer : Don Henley
The Curly Shuffle : Jump 'n The Saddle
The Glamorous Life : Sheila E
The Heart Of Rock & Roll : Huey Lewis & The News
The Language Of Love : Dan Fogelberg
The Last Time I Made Love : Joyce Kennedy & Jeffrey Osborne
The Longest Time : Billy Joel
The Politics Of Dancing : Re-flex
The Reflex : Duran Duran
The Warrior : Scandal Featuring Patty Smyth
There Goes My Baby : Donna Summer
They Don't Know : Tracey Ullman
Think Of Laura : Christopher Cross
This Woman : Kenny Rogers
Thriller : Michael Jackson
Time After Time : Cyndi Lauper
Time Will Reveal : Debarge
To All The Girls I've Loved Before : Julio Iglesias And Willie Nelson
Torture : The Jacksons
Undercover Of The Night : The Rolling Stones
Understanding : Bob Seger
Valotte : Julian Lennon
Wake Me Up Before You Go-Go : Wham!
We Belong : Pat Benatar
We're Not Gonna Take It : Twisted Sister
What About Me? : Kenny Rogers With Kim Carnes & James Ingram
What Is Love : Howard Jones
What's Love Got To Do With It : Tina Turner
Whisper To A Scream (Birds Fly) : Icicle Works
White Horse : Laid Back
Who Wears These Shoes? : Elton John
Who's That Girl : Eurythmics
Wrapped Around Your Finger : The Police
Yah Mo B There : James Ingram With Michael McDonald
You Can't Get What You Want : Joe Jackson
You Might Think : The Cars
