(I ve Had) The Time Of My Life : Bill Medley
(Sittin' On) The Dock Of The Bay : Michael Bolton
1-2-3 : Gloria Estefan
853-5937 : Squeeze
A Word In Spanish : Elton John
All Fired Up : Pat Benatar
Alphabet St. : Prince
Always On My Mind : Pet Shop Boys
Angel : Aerosmith
Another Lover : Giant Steps
Anything For You : Gloria Estefan & Miami Sound Machine
Baby, I Love Your Way/Freebird Medley : Will To Power
Bad Medicine : Bon Jovi
Be Still My Beating Heart : Sting
Because Of You : The Cover Girls
Beds Are Burning : Midnight Oil
Chains Of Love : Erasure
Check It Out : John Mellencamp
Da'Butt (From The "School Daze" Soundtrack) : E.U.
Desire : U2
Devil Inside : INXS
Do You Love Me : The Contours
Don t Be Cruel : Bobby Brown
Don t Know What You Got (Till It s Gone) : Cinderella
Don t Worry, Be Happy (From "Cocktail") : Bobby McFerrin
Don t You Know What The Night Can Do? : Steve Winwood
Downtown Life : Daryl Hall John Oates
Dreaming : Orchestral Manoeuvres In The Dark
Early In The Morning : Robert Palmer
Edge Of A Broken Heart : Vixen
Electric Blue : Icehouse
Endless Summer Nights : Richard Marx
Every Rose Has Its Thorn : Poison
Everywhere : Fleetwood Mac
Fast Car : Tracy Chapman
Father Figure : George Michael
Finish What Ya Started : Van Halen
Fishnet : Morris Day
Forever Young : Rod Stewart
Get Outta My Dreams, Get Into My Car : Billy Ocean
Girlfriend : Pebbles
Giving You The Best That I Got : Anita Baker
Going Back To Cali (From "Less Than Zero") : LL Cool J
Groovy Kind Of Love : Phil Collins
Heart Of Mine : Boz Scaggs
Here With Me : REO Speedwagon
Honestly : Stryper
How Can I Fall? : Breathe
Hysteria : Def Leppard
I Don t Want Your Love : Duran Duran
I Don't Want To Live Without You : Foreigner
I Get Weak : Belinda Carlisle
I Know You're Out There Somewhere : The Moody Blues
I Remember Holding You : Boys Club
I Saw Him Standing There : Tiffany
I Still Believe : Brenda K. Starr
I Want Her : Keith Sweat
I Want To Be Your Man : Roger
I Wish I Had A Girl : Henry Lee Summer
I'm Still Searching : Glass Tiger
If It Isn t Love : New Edition
In Your Room : Bangles
In Your Soul : Corey Hart
Indestructible : Four Tops
Is This Love : Whitesnake
It Takes Two : Rob Base
Just Got Paid : Johnny Kemp
Just Like Heaven : The Cure
Just Like Paradise : David Lee Roth
Kiss : The Art Of Noise Featuring Tom Jones
Kiss And Tell (From "Bright Lights, Big City") : Bryan Ferry
Kiss Me Deadly : Lita Ford
Kokomo (From The "Cocktail" Soundtrack) : The Beach Boys
Little Liar : Joan Jett And The Blackhearts
Live My Life (From The Film "Hiding Out") : Boy George
Look Away : Chicago
Love Changes (Everything) : Climie Fisher
Love Overboard : Gladys Knight
Love Overboard : Gladys Knight & The Pips
Make Me Lose Control : Eric Carmen
Man In The Mirror : Michael Jackson
Motortown : The Kane Gang
My Girl : Suave
Naughty Girls (Need Love Too) : Samantha Fox
Never Gonna Give You Up : Rick Astley
Never Knew Love Like This : Alexander O Neal Featuring Cherrelle
Never Knew Love Like This : Alexander O'Neal Featuring Cherrelle
Nightime : Pretty Poison
Nite And Day : Al B. Sure!
Nobody s Fool (Theme From "Caddyshack II") : Kenny Loggins
Not Just Another Girl : Ivan Neville
One Good Reason : Paul Carrack
One Good Woman : Peter Cetera
One Step Up : Bruce Springsteen
Out Of The Blue : Debbie Gibson
Pamela : Toto
Paradise : Sade
Parents Just Don t Understand : D.J. Jazzy Jeff
Parents Just Don't Understand : D.J. Jazzy Jeff & The Fresh Prince
Perfect World : Huey Lewis & The News
Piano In The Dark : Brenda Russell Featuring Joe Esposito
Pink Cadillac : Natalie Cole
Please Don t Go Girl : New Kids On The Block
Pop Goes The World : Men Without Hats
Power Of Love : Laura Branigan
Prove Your Love : Taylor Dayne
Pump Up The Volume : M/A/R/R/S
Push It : Salt-N-Pepa
Put A Little Love In Your Heart : Annie Lennox
Red Red Wine : UB40
Rhythm Of Love : Yes
Ritual : Dan Reed Network
Rock Of Life : Rick Springfield
Rocket 2 U : The Jets
Rush Hour : Jane Wiedlin
Say It Again : Jermaine Stewart
Sayin Sorry (Don t Make It Right) : Denise Lopez
Seasons Change : Expose
Shattered Dreams : Johnny Hates Jazz
She's Like The Wind : Patrick Swayze (Featuring Wendy Fraser)
Sign Your Name : Terence Trent D Arby
Silhouette : Kenny G
Small World : Huey Lewis
Some Kind Of Lover : Jody Watley
Spy In The House Of Love : Was (Not Was)
Straight Up : Paula Abdul
Strange But True : Times Two
Supersonic : J.J. Fad
Superstitious : Europe
Sweet Child O' Mine : Guns N' Roses
Symptoms Of True Love : Tracie Spencer
Tall Cool One : Robert Plant
Thanks For My Child : Cheryl "Pepsii" Riley
The Flame : Cheap Trick
The Loco-Motion : Kylie Minogue
The Lover In Me : Sheena Easton
The Promise : When In Rome
The Twist : Fat Boys
The Valley Road : Bruce Hornsby
The Valley Road : Bruce Hornsby & The Range
The Way You Love Me : Karyn White
There s The Girl : Heart
Till I Loved You : Barbra Streisand
Time And Tide : Basia
Tomorrow People : Ziggy Marley
Trouble : Nia Peeples
True Faith : New Order
True Love : Glenn Frey
Twilight World : Swing Out Sister
Two Occasions : The Deele
Under The Milky Way : The Church
Wait : White Lion
Waiting For A Star To Fall : Boy Meets Girl
Walk On Water : Eddie Money
We All Sleep Alone : Cher
Welcome To The Jungle : Guns N Roses
What A Wonderful World : Louis Armstrong
What Have I Done To Deserve This? : Pet Shop Boys & Dusty Springfield
What s On Your Mind (Pure Energy) : Information Society
When I m With You : Sheriff
When We Kiss : Bardeux
When We Was Fab : George Harrison
Where Do Broken Hearts Go : Whitney Houston
Wild Thing : Tone-Loc
Wild World : Maxi Priest
Wild, Wild West : The Escape Club
Wishing Well : Terence Trent D'Arby
Yeah, Yeah, Yeah : Judson Spence
You Don t Know : Scarlett
You Don't Know : Scarlett & Black
