(You re My One And Only) True Love : Seduction
18 And Life : Skid Row
A Little Respect : Erasure
A Shoulder To Cry On : Tommy Page
All She Wants Is : Duran Duran
All This Time : Tiffany
Angel Eyes : The Jeff Healey Band
Angel Of Harlem : U2
Armageddon It : Def Leppard
Baby, I Love Your Way/Freebird Medley : Will To Power
Back On Holiday : Robbie Nevil
Back To Life : Soul II Soul
Birthday Suit (From "Sing") : Johnny Kemp
Born To Be My Baby : Bon Jovi
Bust A Move : Young MC
Call It Love : Poco
Cherish : Madonna
Close My Eyes Forever : Lita Ford (Duet With Ozzy Osbourne)
Coming Home : Cinderella
Cover Of Love : Michael Damian
Cry : Waterfront
Cryin : Vixen
Cuddly Toy (Feel For Me) : Roachford
Dial My Heart : The Boys
Don t Ask Me Why : Eurythmics
Don t Close Your Eyes : Kix
Don t Know Much : Linda Ronstadt (Featuring Aaron Neville)
Don t Look Back : Fine Young Cannibals
Don t Make Me Over : Sybil
Don t Rush Me : Taylor Dayne
Don t Shut Me Out : Kevin Paige
Don t Tell Me Lies : Breathe
Don t Wanna Lose You : Gloria Estefan
Downtown : One 2 Many
Dr. Feelgood : Motley Crue
Dreamin : Vanessa Williams
Early In The Morning : Robert Palmer
Every Rose Has Its Thorn : Poison
Everything : Jody Watley
Feels So Good : Van Halen
Fool For Your Loving : Whitesnake
Friends : Jody Watley With Eric B.
Ghost Town : Cheap Trick
Girl I m Gonna Miss You : Milli Vanilli
Giving You The Best That I Got : Anita Baker
Glamour Boys : Living Colour
Headed For A Heartbreak : Winger
Healing Hands : Elton John
Heaven : Warrant
Heaven Help Me : Deon Estus
Hey Baby : Henry Lee Summer
Hey Ladies : Beastie Boys
Holding On : Steve Winwood
Hooked On You : Sweet Sensation
I Beg Your Pardon : Kon Kan
I Drove All Night : Cyndi Lauper
I Like It : Dino
I Live By The Groove : Paul Carrack
I Remember Holding You : Boys Club
I Wanna Have Some Fun : Samantha Fox
I ll Be Good To You : Quincy Jones Featuring Ray Charles
I m That Type Of Guy : LL Cool J
If I Could Turn Back Time : Cher
If You Don t Know Me By Now : Simply Red
Iko Iko (From "Rain Man") : The Belle Stars
In My Eyes : Stevie B
In Your Room : Bangles
Into The Night : Benny Mardones
It s No Crime : Babyface
It s No Secret : Kylie Minogue
It s Not Enough : Starship
Just Between You And Me : Lou Gramm
Keep On Movin : Soul II Soul (Featuring Caron Wheeler)
Kiss : The Art Of Noise Featuring Tom Jones
Kisses On The Wind : Neneh Cherry
Leave A Light On : Belinda Carlisle
Let Go : Sharon Bryant
Licence To Chill : Billy Ocean
Listen To Your Heart : Roxette
Little Jackie Wants To Be A Star : Lisa Lisa
Little Liar : Joan Jett And The Blackhearts
Look Away : Chicago
Lost In Your Eyes : Debbie Gibson
Love In An Elevator : Aerosmith
Love Shack : The B-52 s
Love Song : Tesla
Love Song : The Cure
Me Myself And I : De La Soul
Me So Horny : The 2 Live Crew
Miss You Like Crazy : Natalie Cole
Miss You Much : Janet Jackson
Mixed Emotions : The Rolling Stones
More Than You Know : Martika
My Brave Face : Paul McCartney
My Heart Can t Tell You No : Rod Stewart
My Heart Skips A Beat : The Cover Girls
My Prerogative : Bobby Brown
Once Bitten Twice Shy : Great White
One : Bee Gees
One : Metallica
Opposites Attract : Paula Abdul (Duet With The Wild Pair)
Orinoco Flow (Sail Away) : Enya
Paradise City : Guns N Roses
Partyman : Prince
Poison : Alice Cooper
Pop Singer : John Mellencamp
Pump Up The Jam : Technotronic
Put A Little Love In Your Heart : Annie Lennox
Put Your Mouth On Me : Eddie Murphy
Right Here Waiting : Richard Marx
Room To Move : Animotion
Rooms On Fire : Stevie Nicks
Runnin Down A Dream : Tom Petty
Sacred Emotion : Donny Osmond
Second Chance : Thirty Eight Special
Send Me An Angel 89 : Real Life
Shake For The Sheik : The Escape Club
She Wants To Dance With Me : Rick Astley
She Won t Talk To Me : Luther Vandross
Shower Me With Your Love : Surface
Silhouette : Kenny G
Sincerely Yours : Sweet Sensation (With Romeo J.D.)
Smooth Criminal : Michael Jackson
So Alive : Love And Rockets
Soul Provider : Michael Bolton
Sowing The Seeds Of Love : Tears For Fears
Stand : R.E.M.
Straight Up : Paula Abdul
Sugar Daddy : Thompson Twins
Surrender To Me (From "Tequila Sunrise") : Ann Wilson
Swing The Mood : Jive Bunny
Talk It Over : Grayson Hugh
Thanks For My Child : Cheryl "Pepsii" Riley
That s The Way : Katrina And The Waves
The Arms Of Orion : Prince (With Sheena Easton)
The Best : Tina Turner
The Doctor : The Doobie Brothers
The End Of The Innocence : Don Henley
The Living Years : Mike
The Love In Your Eyes : Eddie Money
The Lover In Me : Sheena Easton
The Prisoner : Howard Jones
The Promise : When In Rome
The Way You Love Me : Karyn White
Thinking Of You : SaFire
This Time I Know It s For Real : Donna Summer
Through The Storm : Aretha Franklin
Two Hearts : Phil Collins
Veronica : Elvis Costello
Voices Of Babylon : The Outfield
Waiting For A Star To Fall : Boy Meets Girl
Walk The Dinosaur : Was (Not Was)
Walking Away : Information Society
We Didn t Start The Fire : Billy Joel
What I Am : Edie Brickell
What I Like About You : Michael Morales
When I Looked At Him : Expose
When I See You Smile : Bad English
When I m With You : Sheriff
When The Children Cry : White Lion
When The Night Comes : Joe Cocker
Where Are You Now? : Jimmy Harnen With Synch
Wild Thing : Tone-Loc
Wild World : Maxi Priest
Wind Beneath My Wings (From "Beaches") : Bette Midler
You Got It (The Right Stuff) : New Kids On The Block
You Got It : Roy Orbison
