(I Know I Got) Skillz : Shaquille O'Neal
7 : Prince And The New Power Generation
A Whole New World (Aladdin s Theme) : Peabo Bryson
All For Love : Bryan Adams/Rod Stewart/Sting
All That She Wants : Ace Of Base
Alright : Kris Kross Featuring Supercat
Another Sad Love Song : Toni Braxton
Baby I m Yours : Shai
Back To The Hotel : N2Deep
Because The Night : 10,000 Maniacs
Bed Of Roses : Bon Jovi
Better Than You : Lisa Keith
Boom! Shake The Room : Jazzy Jeff
Boom! Shake The Room : Jazzy Jeff & The Fresh Prince
Both Sides Of The Story : Phil Collins
Break It Down Again : Tears For Fears
By The Time This Night Is Over : Kenny G With Peabo Bryson
Can We Talk : Tevin Campbell
Can t Get Enough Of Your Love : Taylor Dayne
Can t Help Falling In Love (From "Sliver") : UB40
Cat s In The Cradle : Ugly Kid Joe
Check Yo Self : Ice Cube Featuring Das EFX
Come Baby Come : K7
Come Inside : Intro
Come Undone : Duran Duran
Connected : Stereo MC s
Creep : Radiohead
Cryin : Aerosmith
Dazzey Duks : Duice
Dedicated : R. Kelly
Ditty : Paperboy
Down With The King : Run-D.M.C.
Dre Day : Dr. Dre
Dreamlover : Mariah Carey
Dreams : Gabrielle
Everything s Gonna Be Alright : Father M.C.
Faithful : Go West
Fields Of Gold : Sting
Flex : Mad Cobra
Forever In Love : Kenny G
Gangsta : Bell Biv Devoe
Gangsta Lean : DRS
Get Away : Bobby Brown
Getto Jam : Domino
Girl U For Me/Lose Control : Silk
Give It Up, Turn It Loose : En Vogue
Here We Go Again! : Portrait
Hey Jealousy : Gin Blossoms
Hey Mr. D.J. : Zhane
Hip Hop Hooray : Naughty By Nature
Hopelessly : Rick Astley
How Do You Talk To An Angel : The Heights
I Can See Clearly Now (From "Cool Runnings") : Jimmy Cliff
I Don t Wanna Fight (From "What s Love Got To Do With It") : Tina Turner
I Feel You : Depeche Mode
I Get Around : 2Pac
I Got A Man : Positive K
I Got A Thang 4 Ya! : Lo-Key?
I Love You Period : Dan Baird
I d Die Without You (From "Boomerang") : P.M. Dawn
I d Do Anything For Love (But I Won t Do That) : Meat Loaf
I ll Never Get Over You (Getting Over Me) : Expose
I m Free : Jon Secada
I m Gonna Be (500 Miles) : The Proclaimers
If : Janet Jackson
If I Had No Loot : Tony Toni Tone
In The Still Of The Nite (From "The Jacksons") : Boyz II Men
Informer : Snow
Insane In The Brain : Cypress Hill
It Was A Good Day : Ice Cube
It s Gonna Be A Lovely Day : The S.O.U.L. S.Y.S.T.E.M.
Jessie : Joshua Kadison
Jump Around : House Of Pain
Just Kickin It : Xscape
Knockin Da Boots : H-Town
Lately : Jodeci
Layla : Eric Clapton
Linger : The Cranberries
Love Can Move Mountains : Celine Dion
Love Is (From "Beverly Hills, 90210") : Vanessa Williams/Brian McKnight
Love Is On The Way : Saigon Kick
Love U More : Sunscreem
Man On The Moon : R.E.M.
More And More : Captain Hollywood Project
Mr. Vain : Culture Beat
Mr. Wendal : Arrested Development
Never A Time : Genesis
Never Keeping Secrets : Babyface
Never Should've Let You Go (From "Sister Act 2") : Hi-Five
No Mistakes : Patty Smyth
No Ordinary Love : Sade
No Rain : Blind Melon
Nothin My Love Can t Fix : Joey Lawrence
One Last Cry : Brian McKnight
One Woman : Jade
Ooh Child : Dino
Please Forgive Me : Bryan Adams
Rain : Madonna
Real Love : Mary J. Blige
Reason To Believe : Rod Stewart
Rebirth Of Slick (Cool Like Dat) : Digable Planets
Regret : New Order
Rhythm Is A Dancer : Snap
Right Here (Human Nature)/Downtown : SWV
Ruffneck : MC Lyte
Rump Shaker : Wreckx-N-Effect
Run To You (From "The Bodyguard") : Whitney Houston
Runaway Train : Soul Asylum
Said I Loved You...But I Lied : Michael Bolton
Saving Forever For You (From "Beverly Hills, 90210") : Shanice
Shoop : Salt-N-Pepa
Show Me Love : Robin S.
Simple Life : Elton John
Six Feet Deep : Geto Boys
Slam : Onyx
Sleeping Satellite : Tasmin Archer
Slow And Sexy : Shabba Ranks (Featuring Johnny Gill)
So Alone : Men At Large
Somebody To Love : George Michael
Something s Goin On : U.N.V.
Soul To Squeeze (From "Coneheads") : Red Hot Chili Peppers
Steam : Peter Gabriel
Sweat (A La La La La Long) : Inner Circle
That s What Love Can Do : Boy Krazy
The Crying Game (From "The Crying Game") : Boy George
The Right Kind Of Love (From "Beverly Hills, 90210") : Jeremy Jordan
The River Of Dreams : Billy Joel
Three Little Pigs : Green Jelly
Time And Chance : Color Me Badd
Two Princes : Spin Doctors
Two Steps Behind (From "Last Action Hero") : Def Leppard
U.N.I.T.Y. : Queen Latifah
Very Special : Big Daddy Kane Feat. Spinderella, L. Williams
Walk On The Ocean : Toad The Wet Sprocket
Walking On Broken Glass : Annie Lennox
What About Your Friends : TLC
What Is Love : Haddaway
What s Up : 4 Non Blondes
What s Up Doc? (Can We Rock) : Fu-Schnickens W/ Shaquille O Neal
What's My Name? : Snoop Dogg
When I Fall In Love (From "Sleepless In Seattle") : Celine Dion And Clive Griffin
When She Cries : Restless Heart
Where You Goin Now : Damn Yankees
Who s Gonna Ride Your Wild Horses : U2
Whoomp! (There It Is) : Tag Team
Whoot, There It Is : 95 South
Wild World : Mr. Big
Will You Be There (From "Free Willy") : Michael Jackson
Would I Lie To You? : Charles
