(I Know I Got) Skillz : Shaquille O Neal
(Lay Your Head On My) Pillow : Tony Toni Tone
(Meet) The Flintstones (From "The Flintstones") : The B.C. 52 s
100% Pure Love : Crystal Waters
All About Soul : Billy Joel
All For Love : Bryan Adams/Rod Stewart/Sting
All I Wanna Do : Sheryl Crow
Always : Bon Jovi
Always : Erasure
And Our Feelings : Babyface
Another Night : Real McCoy
Any Time, Any Place/And On And On : Janet Jackson
Anything (From "Above The Rim") : SWV
Anytime You Need A Friend : Mariah Carey
Baby I Love Your Way (From "Reality Bites") : Big Mountain
Back : Aaliyah
Back In The Day : Ahmad
Be Happy : Mary J. Blige
Beautiful In My Eyes : Joshua Kadison
Because The Night : 10,000 Maniacs
Body : Anita Baker
Booti Call : BLACKstreet
Bop Gun (One Nation) : Ice Cube Featuring George Clinton
Born To Roll : Masta Ace Incorporated
Can You Feel The Love Tonight (From "The Lion King") : Elton John
Cantaloop (Flip Fantasia) : US 3
Choose : Color Me Badd
Come Baby Come : K7
Come To My Window : Melissa Etheridge
Crazy : Aerosmith
Creep : TLC
December 1963 (Oh, What A Night) : Four Seasons
Do You Wanna Get Funky : C+C Music Factory
Don t Take The Girl : Tim McGraw
Don t Turn Around : Ace Of Base
Dreams : Gabrielle
Dunkie Butt (Please Please Please) : 12 Gauge
Endless Love : Luther Vandross
Every Day Of The Week : Jade
Everyday : Phil Collins
Fall Down : Toad The Wet Sprocket
Fantastic Voyage : Coolio
Far Behind : Candlebox
Feenin : Jodeci
Flava In Ya Ear : Craig Mack
Found Out About You : Gin Blossoms
Funkdafied : Da Brat
Funky Y-2-C : The Puppies
Gangsta Lean : DRS
Get Over It : Eagles
Getto Jam : Domino
Gin And Juice : Snoop Doggy Dogg
Give It Up : Public Enemy
Got Me Waiting : Heavy D
Groove Thang : Zhane
Having A Party : Rod Stewart
Here Comes The Hotstepper (From "Ready To Wear") : Ini Kamoze
Hold My Hand : Hootie
I Can See Clearly Now (From "Cool Runnings") : Jimmy Cliff
I Miss You : Aaron Hall
I Never Seen A Man Cry (aka I Seen A Man Die) : Scarface
I Swear : All-4-One
I Wanna Be Down : Brandy
I d Give Anything : Gerald Levert
I ll Make Love To You : Boyz II Men
I ll Remember (From "With Honors") : Madonna
I ll Stand By You : Pretenders
I ll Take You There (From "Threesome") : General Public
I m In The Mood : CeCe Peniston
I m Ready : Tevin Campbell
If You Go : Jon Secada
Juicy/Unbelievable : The Notorious B.I.G.
Keep Ya Head Up : 2Pac
Linger : The Cranberries
Loser : Beck
Love Sneakin Up On You : Bonnie Raitt
Lucas With The Lid Off : Lucas
Lucky One : Amy Grant
Mary Jane s Last Dance : Tom Petty And The Heartbreakers
Misled : Celine Dion
Miss You In A Heartbeat : Def Leppard
Mmm Mmm Mmm Mmm : Crash Test Dummies
Moving On Up : M People
Mr. Vain : Culture Beat
Never Lie : Immature
Never Should ve Let You Go (From "Sister Act 2") : Hi-Five
New Age Girl (From "Dumb And Dumber") : Deadeye Dick
Now And Forever : Richard Marx
Playaz Club : Rappin 4-Tay
Player s Ball : OutKast
Please Forgive Me : Bryan Adams
Practice What You Preach : Barry White
Prayer For The Dying : Seal
Pumps And A Bump : M.C. Hammer
Regulate (From "Above The Rim") : Warren G
Return To Innocence : Enigma
Rock And Roll Dreams Come Through : Meat Loaf
Said I Loved You...But I Lied : Michael Bolton
Shine : Collective Soul
Shoop : Salt-N-Pepa
Short Dick Man : 20 Fingers Featuring Gillette
Stay (I Missed You) (From "Reality Bites") : Lisa Loeb
Stay : Eternal
Streets Of Philadelphia (From "Philadelphia") : Bruce Springsteen
Stroke You Up : Changing Faces
Sukiyaki : 4PM
The Most Beautiful Girl In The World : Prince
The Place Where You Belong (From "Beverly Hills Cop III") : Shai
The Rhythm Of The Night : Corona
The Sweetest Days : Vanessa Williams
Thinkin Problem : David Ball
Thuggish Ruggish Bone : Bone Thugs-N-Harmony
Tootsee Roll : 69 Boyz
Tremor Christ/Spin The Black Circle : Pearl Jam
Turn The Beat Around (From "The Specialist") : Gloria Estefan
U Send Me Swingin : Mint Condition
U Will Know (From "Jason s Lyric") : B.M.U. (Black Men United)
U.N.I.T.Y. : Queen Latifah
Understanding : Xscape
What Is Love : Haddaway
What s The Frequency, Kenneth? : R.E.M.
Whatta Man : Salt-N-Pepa Featuring En Vogue
When We Dance : Sting
Whoomp! (There It Is) : Tag Team
Wild Night : John Mellencamp With Me Shell Ndegeocello
Will You Be There (In The Morning) : Heart
Willing To Forgive : Aretha Franklin
You Better Wait : Steve Perry
You Don t Know How It Feels : Tom Petty
You Gotta Be : Des ree
You Know How We Do It : Ice Cube
You Mean The World To Me : Toni Braxton
Your Body s Callin : R. Kelly
