'Til You Do Me Right : After 7
100% Pure Love : Crystal Waters
1st Of Tha Month : Bone Thugs-N-Harmony
A Girl Like You (From "Empire Records") : Edwyn Collins
Ain't Nuthin' But A She Thing : Salt-N-Pepa
All I Wanna Do : Sheryl Crow
Always : Bon Jovi
Another Night : Real McCoy
Any Man Of Mine/Whose Bed Have Your Boots Been Under? : Shania Twain
Anything : 3T
As I Lay Me Down : Sophie B. Hawkins
Ask Of You (From "Higher Learning") : Raphael Saadiq
Back For Good : Take That
Bang And Blame : R.E.M.
Be My Lover : La Bouche
Beautiful Life : Ace Of Base
Before I Let You Go : BLACKstreet
Big Poppa/Warning : The Notorious B.I.G.
Blessed : Elton John
Boombastic/In The Summertime : Shaggy
Breakfast At Tiffany's : Deep Blue Something
Brown Sugar : D'Angelo
Bullet With Butterfly Wings : The Smashing Pumpkins
Can I Touch You...There? : Michael Bolton
Can't Stop Lovin' You : Van Halen
Can't You See (From "New Jersey Drive") : Total Feat. The Notorious B.I.G.
Candy Rain : Soul For Real
Carnival : Natalie Merchant
Cell Therapy : Goodie Mob.
Comedown : Bush
Constantly : Immature
Cotton Eye Joe : Rednex
Creep : TLC
Dear Mama/Old School : 2Pac
December 1963 (Oh, What A Night) : Four Seasons
December : Collective Soul
Do You Sleep? : Lisa Loeb & Nine Stories
Don't Take It Personal (Just One Of Dem Days) : Monica
Dream About You/Funky Melody : Stevie B
Dreaming Of You : Selena
Every Day Of The Week : Jade
Exhale (Shoop Shoop) (From "Waiting To Exhale") : Whitney Houston
Fantasy : Mariah Carey
Feel Me Flow : Naughty By Nature
Foolin' Around : Changing Faces
Freak Like Me : Adina Howard
Free As A Bird : The Beatles
Freek'n You : Jodeci
Gangsta's Paradise (From "Dangerous Minds") : Coolio Featuring L.V.
Get Down : Craig Mack
Get Ready For This : 2 Unlimited
Give It 2 You : Da Brat
Good : Better Than Ezra
Have You Ever Really Loved A Woman? : Bryan Adams
He's Mine : MoKenStef
Here Comes The Hotstepper (From "Ready To Wear") : Ini Kamoze
Hey Lover : LL Cool J
Hold Me, Thrill Me, Kiss Me, Kill Me (From "Batman Forever") : U2
Hold My Hand : Hootie & The Blowfish
Hold On : Jamie Walters
House Of Love : Amy Grant With Vince Gill
How High (From "The Show") : Redman/Method Man
I Belong To You/How Many Ways : Toni Braxton
I Can Love You Like That : All-4-One
I Got 5 On It : Luniz
I Got Id/Long Road : Pearl Jam
I Hate U : Prince
I Know : Dionne Farris
I Like : Kut Klose
I Like It, I Love It : Tim McGraw
I Live My Life For You : Firehouse
I Miss You : N II U
I Never Seen A Man Cry (aka I Seen A Man Die) : Scarface
I Wanna Be Down : Brandy
I Wish : Skee-Lo
I'd Lie For You (And That's The Truth) : Meat Loaf
I'll Be Around : Rappin' 4-Tay Featuring The Spinners
I'll Be There For You/This House Is Not A Home : The Rembrandts
I'll Be There For You/You're All I Need To Get By : Method Man Featuring Mary J. Blige
I'll Stand By You : Pretenders
I'm Goin' Down : Mary J. Blige
I'm The Only One : Melissa Etheridge
If You Love Me : Brownstone
If You Think You're Lonely Now : K-Ci Hailey
In The House Of Stone And Light : Martin Page
Incarcerated Scarfaces/Ice Cream : Raekwon
Keep Their Heads Ringin' (From "Friday") : Dr. Dre
Kiss From A Rose (From "Batman Forever") : Seal
Let Me Be The One : Blessid Union Of Souls
Mental Picture : Jon Secada
Misery : Soul Asylum
Mishale : Andru Donalds
Missing : Everything But The Girl
My Love Is For Real : Paula Abdul
Name : Goo Goo Dolls
New Age Girl (From "Dumb And Dumber") : Deadeye Dick
No More "I Love You's" : Annie Lennox
On Bended Knee : Boyz II Men
One Of Us : Joan Osborne
One Sweet Day : Mariah Carey & Boyz II Men
Playaz Club : Rappin' 4-Tay
Player's Anthem : Junior M.A.F.I.A.
Practice What You Preach : Barry White
Pretty Girl : Jon B
Roll To Me : Del Amitri
Run-Around : Blues Traveler
Scream/Childhood (From "Free Willy 2") : Michael Jackson & Janet Jackson
Sentimental : Deborah Cox
Set U Free : Planet Soul
Shame (From "A Low Down Dirty Shame") : Zhane
Short Dick Man : 20 Fingers Featuring Gillette
Shy Guy (From "Bad Boys") : Diana King
Someone To Love : Jon B. Featuring Babyface
Somethin' 4 Da Honeyz : Montell Jordan
Sugar Hill : AZ
Sukiyaki : 4PM
Take A Bow : Madonna
Tell Me : Groove Theory
Tell Me When : The Human League
The Rhythm Of The Night : Corona
The Sweetest Days : Vanessa Williams
This Lil' Game We Play : Subway (Featuring 702)
Tonite's Tha Night : Kris Kross
Too Hot : Coolio
Tootsee Roll : 69 Boyz
Total Eclipse Of The Heart : Nicki French
Turn The Beat Around (From "The Specialist") : Gloria Estefan
When Can I See You : Babyface
Who Can I Run To : Xscape
Wild Night : John Mellencamp With Me'Shell Ndegeocello
Wonderful : Adam Ant
You Are Not Alone : Michael Jackson
You Don't Know How It Feels : Tom Petty
You Got It (From "Boys On The Side") : Bonnie Raitt
You Gotta Be : Des'ree
You Remind Me Of Something : R. Kelly
You Used To Love Me : Faith Evans
You Want This/70's Love Groove : Janet Jackson
