...Baby One More Time : Britney Spears
32 Flavors : Alana Davis
A Rose Is Still A Rose : Aretha Franklin
A Song For Mama : Boyz II Men
Adia : Sarah McLachlan
All Cried Out : Allure Featuring 112
All For You : Sister Hazel
All My Life : K-Ci
All My Life : K-Ci & JoJo
All My Love : Queen Pen Featuring Eric Williams
All The Places (I Will Kiss You) : Aaron Hall
Am I Dreaming : Ol Skool [Featuring Keith Sweat & Xscape]
Are You Jimmy Ray? : Jimmy Ray
Are You That Somebody? : Aaliyah
Because Of You : 98 Degrees
Been Around The World : Puff Daddy & The Family (Feat. The Notorious B.I.G. & Mase)
Bitter Sweet Symphony : The Verve
Body Bumpin' Yippie-Yi-Yo : Public Announcement
Breaking All The Rules : She Moves
Can I Get A... : Jay-Z Featuring Amil (Of Major Coinz)
Can I Get A... : Jay-Z Featuring Amil (Of Major Coinz) & Ja
Candle In The Wind 1997/Something About The Way You Look Tonight : Elton John
Changes : 2Pac
Cheers 2 U : Playa
Cleopatra s Theme : Cleopatra
Clock Strikes : Timbaland
Come And Get With Me : Keith Sweat Featuring Snoop Dogg
Come With Me : Puff Daddy Featuring Jimmy Page
Criminal : Fiona Apple
Cruel Summer : Ace Of Base
Crush : Jennifer Paige
Dangerous : Busta Rhymes
Daydreamin' : Tatyana Ali
Deja Vu [Uptown Baby] : Lord Tariq
Deja Vu [Uptown Baby] : Lord Tariq & Peter Gunz
Do For Love : 2Pac Featuring Eric Williams
Doo Wop (That Thing) : Lauryn Hill
Everybody [Backstreet s Back] : Backstreet Boys
Father : LL Cool J
Feel So Good : Mase
Friend Of Mine : Kelly Price
Get At Me Dog : DMX Featuring Sheek Of The Lox
Gettin' Jiggy Wit It : Will Smith
Ghetto Cowboy : Mo Thugs Family Featuring Bone Thugs-N-Harmony
Ghetto Supastar (That Is What You Are) : Pras Michel Feat. Ol Dirty Bastard
Ghetto Supastar (That Is What You Are) : Pras Michel Feat. Ol' Dirty Bastard & Introducing Mya
Given To Fly : Pearl Jam
Going Back To Cali : The Notorious B.I.G.
Gone Till November : Wyclef Jean
Goodbye To My Homies : Master P Featuring Silkk The Shocker, Sons Of Funk And Mo B. Dick
Gotta Be : Jagged Edge
Hands : Jewel
Hard Knock Life (Ghetto Anthem) : Jay-Z
Heaven : Nu Flavor
Heaven s What I Feel : Gloria Estefan
How Deep Is Your Love : Dru Hill Featuring Redman
How's It Going To Be : Third Eye Blind
Husbands And Wives : Brooks
I Can Do That : Montell Jordan
I Do : Lisa Loeb
I Don't Ever Want To See You Again : Uncle Sam
I Don't Want To Miss A Thing : Aerosmith
I Don't Want To Wait : Paula Cole
I Get Lonely : Janet Featuring BLACKstreet
I Got The Hook Up! : Master P Featuring Sons Of Funk
I Want You Back : 'N Sync
I Want You Back : N Sync
I Will Come To You : Hanson
I ll Be : Edwin McCain
I m Your Angel : R. Kelly
If I Could Teach The World : Bone Thugs-N-Harmony
If You Think I'm Jiggy : The Lox
Inside Out : Eve 6
Intergalactic : Beastie Boys
Iris : Goo Goo Dolls
It Must Be Love : Ty Herndon
It s All About Me : Mya
It's All About Me : Mya & Sisqo
Kiss The Rain : Billie Myers
Lately : Divine
Let s Ride : Montell Jordan Feat. Master P
Let's Ride : Montell Jordan Feat. Master P & Silkk The Shocker
Lollipop (Candyman) : Aqua
Lookin' At Me : Mase Featuring Puff Daddy
Looking Through Your Eyes : LeAnn Rimes
Love Like This : Faith Evans
Love Me : 112 Featuring Mase
Love You Down : INOJ/LATHUN
Lullaby : Shawn Mullins
Make Em Say Uhh! : Master P Feat. Fiend, Silkk The Shocker, Mia X
Make Em' Say Uhh! : Master P Feat. Fiend, Silkk The Shocker, Mia X & Mystikal
Make It Hot : Nicole Featuring Missy "Misdemeanor" Elliott
Make It Hot : Nicole Featuring Missy "Misdemeanor" Elliott & Mocha
Mo Money Mo Problems : The Notorious B.I.G. Featuring Puff Daddy & Mase
Money, Power & Respect : The Lox [Featuring DMX & Lil' Kim]
Money, Power : The Lox [Featuring DMX
Movin' On : Mya Featuring Silkk The Shocker
My All : Mariah Carey
My Body : LSG
My Favorite Mistake : Sheryl Crow
My Heart Will Go On : Celine Dion
My Love Is The Shhh! : Somethin' For The People Featuring Trina & Tamara
My Way : Usher
Never Ever : All Saints
No, No, No : Destiny s Child
No, No, No : Destiny's Child
Nobody Does It Better : Nate Dogg Featuring Warren G
Nobody Else : Tyrese
Nobody s Supposed To Be Here : Deborah Cox
One Week : Barenaked Ladies
Ooh La La : Rod Stewart
Pushin Weight : Ice Cube Featuring Mr. Short Khop
Rain : SWV
Raise The Roof : Luke Featuring No Good But So Good
Ray Of Light : Madonna
Real World : matchbox 20
Romeo And Juliet : Sylk-E. Fyne Featuring Chill
Save Tonight : Eagle-Eye Cherry
Say It : Voices Of Theory
Second Round K.O. : Canibus
Sex And Candy : Marcy Playground
Shorty (You Keep Playin With My Mind) : Imajin Featuring Keith Murray
Show Me Love : Robyn
So Into You : Tamia
Sock It 2 Me : Missy "Misdemeanor" Elliott Featuring Da Brat
Someone You Used To Know : Collin Raye
Splackavellie : Pressha
Still A G Thang : Snoop Dogg
Still Not A Player : Big Punisher Featuring Joe
SuperThug (What What) : Noreaga
Swing My Way : K.P.
Swing My Way : K.P. & Envyi
Take Me There : BLACKstreet
Thank U : Alanis Morissette
The Arms Of The One Who Loves You : Xscape
The Boy Is Mine : Brandy
The Boy Is Mine : Brandy & Monica
The First Night : Monica
The Memory Remains : Metallica
The Mummers' Dance : Loreena McKennitt
The Party Continues : JD Featuring Da Brat
There s Your Trouble : Dixie Chicks
They Don t Know : Jon B.
They Don't Know : Jon B
Thinkin' Bout It : Gerald Levert
This Kiss : Faith Hill
Time After Time : Inoj
Together Again : Janet
Too Close : Next
Too Much : Spice Girls
Touch It : Monifah
Trippin : Total Featuring Missy Elliott
Truly Madly Deeply : Savage Garden
Tubthumping : Chumbawamba
Victory : Puff Daddy
Victory : Puff Daddy & The Family Featuring The Notorious B.I.G. & Busta Rh
We're Not Making Love No More : Dru Hill
Westside : TQ
What About Us : Total
What You Want : Mase Featuring Total
Whatcha Gone Do? : Link
When The Lights Go Out : Five
Who Am I : Beenie Man
Woof Woof : 69 Boyz
You re Beginning To Get To Me : Clay Walker
You re Easy On The Eyes : Terri Clark
You're Still The One : Shania Twain
