(Hot S**t) Country Grammar : Nelly
24/7 : Kevon Edmonds
4, 5, 6 : Sole Featuring JT Money
4, 5, 6 : Sole Featuring JT Money & Kandi
911 : Wyclef Jean Featuring Mary J. Blige
Aaron s Party (Come Get It) : Aaron Carter
Absolutely (Story Of A Girl) : Nine Days
Again : Lenny Kravitz
All The Small Things : Blink-182
Amazed : Lonestar
American Pie : Madonna
Another Dumb Blonde : Hoku
Auld Lang Syne : Kenny G
Back At One : Brian McKnight
Back At One : Mark Wills
Back Here : BBMak
Back That Thang Up : Juvenile Featuring Mannie Fresh
Back That Thang Up : Juvenile Featuring Mannie Fresh & Lil' Wayne
Bag Lady : Erykah Badu
Be With You : Enrique Iglesias
Beautiful Day : U2
Bent : matchbox twenty
Best Of Intentions : Travis Tritt
Better Off Alone : Alice Deejay
Between Me And You : Ja Rule Featuring Christina Milian
Big Deal : LeAnn Rimes
Big Pimpin : Jay-Z Featuring UGK
Blue (Da Ba Dee) : Eiffel 65
Born To Fly : Sara Evans
Bounce With Me : Lil Bow Wow Featuring Xscape
Breathe : Faith Hill
Bring It All To Me : Blaque
Broadway : Goo Goo Dolls
Buy Me A Rose : Kenny Rogers With Alison Krauss
Bye Bye Bye : N Sync
Callin Me : Lil Zane Featuring 112
Case Of The Ex (Whatcha Gonna Do) : Mya
Crazy : K-Ci & JoJo
Crazy For This Girl : Evan And Jaron
Crybaby : Mariah Carey Featuring Snoop Dogg
Dance Tonight : Lucy Pearl
Dance With Me : Debelah Morgan
Dancin' : Guy
Danger (Been So Long) : Mystikal Featuring Nivea
Desert Rose : Sting Featuring Cheb Mami
Doesn t Really Matter : Janet
Don t Think I m Not : Kandi
Don't Say You Love Me : M2M
Everything You Want : Vertical Horizon
Faded : SoulDecision Featuring Thrust
Falls Apart : Sugar Ray
Forgot About Dre : Dr. Dre Featuring Eminem
Get Gone : Ideal
Get It On Tonite : Montell Jordan
Girl On TV : LFO
Give Me Just One Night (Una Noche) : 98 Degrees
Goodbye Earl : Dixie Chicks
Got To Get It : Sisqo Featuring Make It Hot
Got Your Money : Ol Dirty Bastard Featuring Kelis
Got Your Money : Ol' Dirty Bastard Featuring Kelis
Gotta Tell You : Samantha Mumba
Graduation (Friends Forever) : Vitamin C
Hanginaround : Counting Crows
He Can t Love U : Jagged Edge
He Didn't Have To Be : Brad Paisley
He Loves U Not : Dream
He Wasn t Man Enough : Toni Braxton
Hemorrhage (In My Hands) : Fuel
Higher : Creed
Hot Boyz : Missy "Misdemeanor" Elliott Featuring NAS, EVE
Hot Boyz : Missy "Misdemeanor" Elliott Featuring NAS, EVE & Q-Tip
How Do You Like Me Now?! : Toby Keith
I Hope You Dance : Lee Ann Womack
I Hope You Dance : Lee Ann Womack With Sons Of The Desert
I Just Wanna Love U (Give It 2 Me) : Jay-Z
I Knew I Loved You : Savage Garden
I Learned From The Best : Whitney Houston
I Like It : Sammie
I Lost It : Kenny Chesney
I Try : Macy Gray
I Wanna Be With You : Mandy Moore
I Wanna Know : Joe
I Wanna Love You Forever : Jessica Simpson
I Will Love Again : Lara Fabian
I Wish : Carl Thomas
I Wish : R. Kelly
If You Love Me : Mint Condition
It Feels So Good : Sonique
It Must Be Love : Alan Jackson
It Wasn t Me : Shaggy Featuring Ricardo "RikRok" Ducent
It s My Life : Bon Jovi
It's Gonna Be Me : 'N Sync
Just Another Day In Paradise : Phil Vassar
Just Friends (Sunny) : Musiq
Kryptonite : 3 Doors Down
Learn To Fly : Foo Fighters
Lessons Learned : Tracy Lawrence
Liar : Profyle
Liquid Dreams : O-Town
Love Is Blind : Eve Featuring Faith Evans
Mambo No. 5 (A Little Bit Of...) : Lou Bega
Maria Maria : Santana Featuring The Product G
Maria Maria : Santana Featuring The Product G&B
Meet Virginia : Train
Ms. Jackson : OutKast
My Best Friend : Tim McGraw
My First Love : Avant Featuring Ketara Wyatt
Never Let You Go : Third Eye Blind
No More : Ruff Endz
One Night Stand : J-Shin Featuring LaTocha Scott
One Voice : Billy Gilman
Only God Knows Why : Kid Rock
Oops!...I Did It Again : Britney Spears
Otherside : Red Hot Chili Peppers
Party Up (Up In Here) : DMX
Pinch Me : Barenaked Ladies
Prayin For Daylight : Rascal Flatts
Purest Of Pain (A Puro Dolor) : Son By Four
Say My Name : Destiny s Child
Say My Name : Destiny's Child
Separated : Avant
Shackles (Praise You) : Mary Mary
Shake Ya Ass : Mystikal
Shake Your Bon-Bon : Ricky Martin
She s More : Andy Griggs
Show Me The Meaning Of Being Lonely : Backstreet Boys
Simple Kind Of Life : No Doubt
Smooth : Santana Featuring Rob Thomas
So In Love With Two : Mikaila
Stay The Night : IMx
Steal My Sunshine : Len
Swear It Again : Westlife
Take A Picture : Filter
Thank God I Found You : Mariah Carey Featuring Joe
That s The Way : Jo Dee Messina
That s The Way It Is : Celine Dion
The Best Day : George Strait
The Chain Of Love : Clay Walker
The Little Girl : John Michael Montgomery
The Next Episode : Dr. Dre Featuring Snoop Dogg
The Real Slim Shady : Eminem
Then The Morning Comes : Smash Mouth
There You Go : Pink
This Time Around : Hanson
Thong Song : Sisqo
Try Again : Aaliyah
U Know What s Up : Donell Jones
Unpretty : TLC
Untitled (How Does It Feel) : D Angelo
Waiting For Tonight : Jennifer Lopez
What A Girl Wants : Christina Aguilera
What Chu Like : Da Brat Featuring Tyrese
What Do You Say : Reba
What s Your Fantasy : Ludacris Featuring Shawna
Where My Girls At? : 702
Who Let The Dogs Out : Baha Men
Wifey : Next
Wobble Wobble : 504 Boyz
Wonderful : Everclear
Yes! : Chad Brock
You Can Do It : Ice Cube Featuring Mack 10
You Sang To Me : Marc Anthony
