4 Minutes : Madonna Featuring Justin Timberlake
A Milli : Lil Wayne
Addicted : Saving Abel
All Around Me : Flyleaf
All I Want To Do : Sugarland
All Summer Long : Hit Masters
All Summer Long : Kid Rock
All Summer Long : The Rock Heroes
All-American Girl : Carrie Underwood
American Boy : Estelle Featuring Kanye West
Apologize : Timbaland Featuring OneRepublic
Beat It : Fall Out Boy Featuring John Mayer
Beautiful : Akon Featuring Colby O'Donis & Kardinal Offishall
Bleeding Love : Leona Lewis
Bubbly : Colbie Caillat
Burnin' Up : Jonas Brothers
Bust It Baby Part 2 : Plies Featuring Ne-Yo
Can't Believe It : T-Pain Featuring Lil Wayne
Can't Help But Wait : Trey Songz
Chicken Fried : Zac Brown Band
Chinese Democracy : Guns N' Roses
Chopped 'N' Skrewed : T-Pain Featuring Ludacris
Cleaning This Gun (Come On In Boy) : Rodney Atkins
Closer : Ne-Yo
Clumsy : Fergie
Corona And Lime : Shwayze
Crank That (Soulja Boy) : Soulja Boy Tell'em
Crush : David Archuleta
Crying Out For Me : Mario
Cyclone : Baby Bash Featuring T-Pain
Damaged : Danity Kane
Dangerous : Kardinal Offishall Featuring Akon
Dey Know : Shawty Lo
Do You Believe Me Now : Jimmy Wayne
Don't Stop The Music : Rihanna
Don't Think I Don't Think About It : Darius Rucker
Duffle Bag Boy : Playaz Circle Featuring Lil Wayne
Elevator : Flo Rida Featuring Timbaland
Fall For You : Secondhand Serenade
Feedback : Janet
Flashing Lights : Kanye West Featuring Dwele
Freeze : T-Pain Featuring Chris Brown
Get Like Me : David Banner Featuring Chris Brown
Get Silly : V.I.C.
Gives You Hell : The All-American Rejects
Good Life : Kanye West Featuring T-Pain
Good Time : Alan Jackson
Got Money : Lil Wayne Featuring T-Pain
Gotta Be Somebody : Nickelback
Gotta Find You : Joe Jonas
Green Light : John Legend Featuring Andre 3000
Handlebars : Flobots
Hate That I Love You : Rihanna Featuring Ne-Yo
How Far We've Come : matchbox twenty
Human : The Killers
Hypnotized : Plies Featuring Akon
I Don't Care : Fall Out Boy
I Don't Wanna Be In Love (Dance Floor Anthem) : Good Charlotte
I Kissed A Girl : Katy Perry
I Luv Your Girl : The-Dream
I Remember : Keyshia Cole
I Saw God Today : George Strait
I Won't Tell : Fat Joe Featuring J. Holiday
I'm So Hood : DJ Khaled Featuring T-Pain, Trick Daddy, Rick Ross & Plies
I'm So Paid : Akon Featuring Lil Wayne
I'm So Paid : Akon Featuring Lil Wayne & Young Jeezy
I'm Still A Guy : Brad Paisley
I'm Yours : Jason Mraz
If I Were A Boy : Beyonce
In Love With A Girl : Gavin DeGraw
In The Ayer : Flo Rida Featuring will.i.am
Independent : Webbie, Lil' Phat & Lil' Boosie
Into The Night : Santana Featuring Chad Kroeger
It's Not My Time : 3 Doors Down
Just Dance : Lady GaGa Featuring Colby O'Donis
Just Fine : Mary J. Blige
Just Got Started Lovin' You : James Otto
Just Stand Up! : Artists Stand Up To Cancer
Keeps Gettin' Better : Christina Aguilera
Killa : Cherish Featuring Yung Joc
Kiss Kiss : Chris Brown Featuring T-Pain
Krazy : Pitbull Featuring Lil Jon
Leavin' : Jesse McCartney
Let It Rock : Kevin Rudolf Featuring Lil Wayne
Live Your Life : T.I. Featuring Rihanna
Lolli Lolli (Pop That Body) : Three 6 Mafia Featuring Project Pat, Young D & Superpower
Lollipop : Lil Wayne Featuring Static Major
Love In This Club : Usher Featuring Young Jeezy
Love In This Club Part II : Usher Featuring Beyonce & Lil Wayne
Love Like This : Natasha Bedingfield Featuring Sean Kingston
Love Remains The Same : Gavin Rossdale
Love Song : Sara Bareilles
Low : Flo Rida Featuring T-Pain
Mercy : Duffy
Misery Business : Paramore
Mrs. Officer : Lil Wayne Featuring Bobby Valentino
Mrs. Officer : Lil Wayne Featuring Bobby Valentino & Kidd Kidd
My Life : The Game Featuring Lil Wayne
Need U Bad : Jazmine Sullivan
New Soul : Yael Naim
No Air : Jordin Sparks Duet With Chris Brown
No One : Alicia Keys
Nude : Radiohead
One More Drink : Ludacris Co-Starring T-Pain
Out Here Grindin : DJ Khaled Feat. Akon, Plies, Young Jeezy, Rick Ross, Ace Hood, Trick Daddy & Lil' Boosie
Out Here Grindin : DJ Khaled Featuring Akon, Rick Ross, Young Jeezy, Lil' Boosie, Trick Daddy, Ace Hood & Pli
Over You : Daughtry
Paper Planes : M.I.A.
Paralyzer : Finger Eleven
Party People : Nelly Featuring Fergie
Piece Of Me : Britney Spears
Pocketful Of Sunshine : Natasha Bedingfield
Pop Bottles : Birdman Featuring Lil Wayne
Pop Champagne : Jim Jones & Ron Browz Featuring Juelz Santana
Put On : Young Jeezy Featuring Kanye West
Ready, Set, Don't Go : Billy Ray Cyrus With Miley Cyrus
Right Here (Departed) : Brandy
Right Now (Na Na Na) : Akon
Roll With Me : Montgomery Gentry
Say : John Mayer
See You Again : Miley Cyrus
See You In My Nightmares : Kanye West Featuring Lil Wayne
Sensual Seduction : Snoop Dogg
Sexy Can I : Ray J & Yung Berg
Shadow Of The Day : Linkin Park
Shake It : Metro Station
Shattered (Turn The Car Around) : O.A.R.
Shawty Get Loose : Lil Mama Featuring Chris Brown & T-Pain
She Got It : 2 Pistols Featuring T-Pain & Tay Dizm
So What : Pink
Sorry : Buckcherry
Spotlight : Jennifer Hudson
Stop And Stare : OneRepublic
Stronger : Kanye West
Suffocate : J. Holiday
Summertime : New Kids On The Block
Superstar : Lupe Fiasco Featuring Matthew Santos
Swagga Like Us : Jay-Z & T.I. Featuring Kanye West & Lil Wayne
Sweetest Girl (Dollar Bill) : Wyclef Jean Featuring Akon, Lil Wayne & Niia
T-Shirt : Shontelle
Take You There : Sean Kingston
Tattoo : Jordin Sparks
Teardrops On My Guitar : Taylor Swift
The Boss : Rick Ross Featuring T-Pain
The Business : Yung Berg Featuring Casha
The Day That Never Comes : Metallica
The Time Of My Life : David Cook
The Way I Are : Timbaland Featuring Keri Hilson
The Way That I Love You : Ashanti
This Is Me : Demi Lovato & Joe Jonas
Touch My Body : Mariah Carey
Untouched : The Veronicas
Viva La Vida : Coldplay
Wake Up Call : Maroon 5
We Rock : Cast Of Camp Rock
What Them Girls Like : Ludacris Co-Starring Chris Brown & Sean Garrett
What You Got : Colby O'Donis Featuring Akon
Whatever It Takes : Lifehouse
Whatever You Like : T.I.
When I Grow Up : The Pussycat Dolls
With You : Chris Brown
You Found Me : The Fray
You're Gonna Miss This : Trace Adkins
