1, 2, 3, 4 : Plain White T's
21 Guns : Green Day
Addicted : Saving Abel
All The Above : Maino Featuring T-Pain
Alright : Darius Rucker
American Ride : Toby Keith
Baby By Me : 50 Cent Featuring Ne-Yo
Battlefield : Jordin Sparks
Be On You : Flo Rida Featuring Ne-Yo
Beautiful : Akon Featuring Colby O'Donis & Kardinal Offishall
Beautiful : Eminem
Bedrock : Young Money Featuring Lloyd
Best I Ever Had : Drake
Big Green Tractor : Jason Aldean
Birthday Sex : Jeremih
Blame It : Jamie Foxx Featuring T-Pain
Body Language : Jesse McCartney Featuring T-Pain
Break Up : Mario Featuring Gucci Mane & Sean Garrett
Can't Believe It : T-Pain Featuring Lil Wayne
Carry Out : Timbaland Featuring Justin Timberlake
Chasing Pavements : Adele
Chicken Fried : Zac Brown Band
Chopped 'N' Skrewed : T-Pain Featuring Ludacris
Circus : Britney Spears
Consider Me Gone : Reba
Cowboy Casanova : Carrie Underwood
Crack A Bottle : Eminem, Dr. Dre & 50 Cent
Crush : David Archuleta
D.O.A. (Death Of Auto-Tune) : Jay-Z
Day 'N' Nite : Kid Cudi
Dead And Gone : T.I. Featuring Justin Timberlake
Decode : Paramore
Defying Gravity : Glee Cast Featuring Chris Colfer & Lea Michele
Do I : Luke Bryan
Do You Remember : Jay Sean Featuring Sean Paul & Lil Jon
Don't Trust Me : 3OH!3
Down : Jay Sean Featuring Lil Wayne
Drop It Low : Ester Dean Featuring Chris Brown
Empire State Of Mind : Jay-Z + Alicia Keys
Evacuate The Dancefloor : Cascada
Every Girl : Young Money
Fall For You : Secondhand Serenade
Fallin' For You : Colbie Caillat
Feel That Fire : Dierks Bentley
Fire Burning : Sean Kingston
Fireflies : Owl City
Forever : Drake Featuring Kanye West, Lil Wayne & Eminem
Funny The Way It Is : Dave Matthews Band
Gangsta Luv : Snoop Dogg Featuring The-Dream
Get On Your Boots : U2
Gettin' You Home (The Black Dress Song) : Chris Young
Give It Up To Me : Shakira Featuring Lil Wayne
Gives You Hell : The All-American Rejects
Good Girls Go Bad : Cobra Starship Featuring Leighton Meester
Good Morning : Chamillionaire
Goodbye : Kristinia Debarge
Gotta Be Somebody : Nickelback
Green Light : John Legend Featuring Andre 3000
Half Of My Heart : John Mayer Featuring Taylor Swift
Happy : Leona Lewis
Hard : Rihanna Featuring Jeezy
He Could Be The One : Hannah Montana
Heartless : Kanye West
Her Diamonds : Rob Thomas
Here Comes Goodbye : Rascal Flatts
Here We Go Again : Demi Lovato
Hot N Cold : Katy Perry
Hot Revolver : Lil Wayne
Hotel Room Service : Pitbull
How Do You Sleep? : Jesse McCartney Featuring Ludacris
How Low : Ludacris
I Can Transform Ya : Chris Brown Featuring Lil Wayne & Swizz Beatz
I Don't Care : Fall Out Boy
I Gotta Feeling : The Black Eyed Peas
I Hate This Part : The Pussycat Dolls
I Love College : Asher Roth
I Told You So : Carrie Underwood Featuring Randy Travis
I Will Not Bow : Breaking Benjamin
I'm Alive : Kenny Chesney With Dave Matthews
I'm Going In : Drake Featuring Lil Wayne & Young Jeezy
I'm So Paid : Akon Featuring Lil Wayne & Young Jeezy
I'm Yours : Jason Mraz
Ice Cream Paint Job : Dorrough
It Happens : Sugarland
It's My Life / Confessions Part II : Glee Cast
Jai Ho! (You Are My Destiny) : A R Rahman & The Pussycat Dolls Featuring Nicole Scherzinger
Just Dance : Lady GaGa Featuring Colby O'Donis
Kiss Me Thru The Phone : Soulja Boy Tell 'em Featuring Sammie
Knock You Down : Keri Hilson Featuring Kanye West & Ne-Yo
Let It Rock : Kevin Rudolf Featuring Lil Wayne
Light On : David Cook
Live Like We're Dying : Kris Allen
Live Your Life : T.I. Featuring Rihanna
Lost! : Coldplay With Jay-Z
Love Drunk : Boys Like Girls
Love Sex Magic : Ciara Featuring Justin Timberlake
Love Story : Taylor Swift
Mad : Ne-Yo
Mad World : Adam Lambert
Money To Blow : Birdman Featuring Lil Wayne & Drake
Mrs. Officer : Lil Wayne Featuring Bobby Valentino & Kidd Kidd
My Life Would Suck Without You : Kelly Clarkson
Need You Now : Lady Antebellum
New Divide : Linkin Park
No Surprise : Daughtry
Obsessed : Mariah Carey
Old Time's Sake : Eminem Featuring Dr. Dre
One More Drink : Ludacris Co-Starring T-Pain
One Time : Justin Bieber
Only You Can Love Me This Way : Keith Urban
Out Last Night : Kenny Chesney
Papers : Usher
Paranoid : Jonas Brothers
Party In The U.S.A. : Miley Cyrus
People Are Crazy : Billy Currington
Poker Face : Lady GaGa
Pop Champagne : Jim Jones & Ron Browz Featuring Juelz Santana
Pretty Wings : Maxwell
Put It On Ya : Plies Featuring Chris J
Rehab : Rihanna
Remember Me : T.I. Featuring Mary J. Blige
Replay : Iyaz
Right Now (Na Na Na) : Akon
Right Round : Flo Rida
Right Round : Flo Rida Featuring Ke$ha
Rockin' That Thang : The-Dream
Roll With Me : Montgomery Gentry
Run This Town : Jay-Z, Rihanna & Kanye West
Say Aah : Trey Songz Featruing Fabolous
Say Aah : Trey Songz Featuring Fabolous
Say Hey (I Love You) : Michael Franti & Spearhead Featuring Cherine Anderson
Second Chance : Shinedown
Send It On : Disney's Friends For Change
Sexy Chick : David Guetta Featuring Akon
Shattered (Turn The Car Around) : O.A.R.
She Wolf : Shakira
Single Ladies (Put A Ring On It) : Beyonce
Sober : Pink
Successful : Drake Featuring Trey Songz & Lil Wayne
Sugar : Flo Rida Featuring Wynter
Sweet Caroline : Glee Cast Featuring Mark Salling
Telephone : Lady Gaga Featuring Beyonce
That's Not My Name : The Ting Tings
Then : Brad Paisley
Throw It In The Bag : Fabolous Featuring The-Dream
TiK ToK : Ke$ha
Tie Me Down : New Boyz Feat. Ray J
Turn My Swag On : Soulja Boy Tell'em
Turnin Me On : Keri Hilson Featuring Lil Wayne
Two Is Better Than One : Boys Like Girls Featuring Taylor Swift
Untouched : The Veronicas
Uprising : Muse
Use Somebody : Kings Of Leon
Viva La Vida : Coldplay
Wanted : Jessie James
Wasted : Gucci Mane Featuring Plies Or OJ Da Juiceman
Whatcha Say : Jason DeRulo
Whatever You Like : T.I.
White Liar : Miranda Lambert
Who Says : John Mayer
You Found Me : The Fray
You're A Jerk : New Boyz
