2012 (It Ain't The End) : Jay Sean Featuring Nicki Minaj
3 : Britney Spears
According To You : Orianthi
Airplanes : B.o.B Featuring Eminem & Haley Williams
Airplanes : B.o.B Featuring Hayley Williams
Airplanes : B.o.B Featuring Hayley Williams Of Paramore
All About Tonight : Blake Shelton
All I Do Is Win : DJ Khaled Featuring T-Pain, Ludacris, Snoop Dogg & Rick Ross
All The Right Moves : OneRepublic
Already Gone : Kelly Clarkson
Animal : Neon Trees
As She's Walking Away : Zac Brown Band Featuring Alan Jackson
Aston Martin Music : Rick Ross Featuring Drake & Chrisette Michele
Baby : Justin Bieber Featuring Ludacris
Baby By Me : 50 Cent Featuring Ne-Yo
Bad Romance : Lady Gaga
Beautiful Day : Lee DeWyze
BedRock : Young Money Featuring Lloyd
Billionaire : Travie McCoy Featuring Bruno Mars
Black And Yellow : Wiz Khalifa
Blah Blah Blah : Ke$ha Featuring 3OH!3
Bottoms Up : Trey Songz Featuring Nicki Minaj
Break Your Heart : Taio Cruz Featuring Ludacris
Breakeven : The Script
Bulletproof : La Roux
California Gurls : Katy Perry Featuring Snoop Dogg
Carry Out : Timbaland Featuring Justin Timberlake
Check It Out : will.i.am & Nicki Minaj
Christmas Lights : Coldplay
Club Can't Handle Me : Flo Rida Featuring David Guetta
Come Back Song : Darius Rucker
Coming Home : Diddy - Dirty Money Featuring Skylar Grey
Cooler Than Me : Mike Posner
DJ Got Us Fallin' In Love : Usher Featuring Pitbull
Deuces : Chris Brown Featuring Tyga & Kevin McCall
Do You Remember : Jay Sean Featuring Sean Paul & Lil Jon
Dog Days Are Over : Florence + The Machine
Down : Jay Sean Featuring Lil Wayne
Dream On : Glee Cast Featuring Neil Patrick Harris
Drop The World : Lil Wayne Featuring Eminem
Dynamite : Taio Cruz
Eenie Meenie : Sean Kingston & Justin Bieber
Empire State Of Mind : Jay-Z + Alicia Keys
Erase Me : Kid Cudi Featuring Kanye West
Evacuate The Dancefloor : Cascada
F**k You (Forget You) : Cee Lo Green
Fallin' For You : Colbie Caillat
Fancy : Drake Featuring T.I. & Swizz Beatz
Felt Good On My Lips : Tim McGraw
Find Your Love : Drake
Fireflies : Owl City
Forever : Drake Featuring Kanye West, Lil Wayne & Eminem
Forget You : Glee Cast Featuring Gwyneth Paltrow
Free : Zac Brown Band
Gangsta Luv : Snoop Dogg Featuring The-Dream
Gettin' Over You : David Guetta & Chris Willis Featuring Fergie & LMFAO
Gimmie That Girl : Joe Nichols
Give It Up To Me : Shakira Featuring Lil Wayne
Gives You Hell : Glee Cast Featuring Lea Michele
Glitter In The Air : Pink
Got Your Back : T.I. Featuring Keri Hilson
Hallelujah : Justin Timberlake & Matt Morris Featuring Charlie Sexton
Hard : Rihanna Featuring Jeezy
Haven't Met You Yet : Michael Buble
Heartbreak Warfare : John Mayer
Hell Breaks Loose : Eminem Featuring Dr. Dre
Hello : Glee Cast Featuring Jonathan Groff & Lea Michele
Hello Good Morning : Diddy - Dirty Money Featuring T.I.
Hey Baby (Drop It To The Floor) : Pitbull Featuring T-Pain
Hey Daddy (Daddy's Home) : Usher Featuring Plies
Hey, Soul Sister : Train
Hillbilly Bone : Blake Shelton Featuring Trace Adkins
Hot Tottie : Usher Featuring Jay-Z
How Low : Ludacris
I Can Transform Ya : Chris Brown Featuring Lil Wayne & Swizz Beatz
I Dreamed A Dream : Glee Cast Featuring Idina Menzel
I Gotta Feeling : The Black Eyed Peas
I Like It : Enrique Iglesias Featuring Pitbull
I Made It (Cash Money Heroes) : Kevin Rudolf Featuring Birdman, Jay Sean, & Lil Wayne
I'm Awesome : Spose
If I Die Young : The Band Perry
If We Ever Meet Again : Timbaland Featuring Katy Perry
Impossible : Shontelle
Jar Of Hearts : Christina Perri
Just A Dream : Nelly
Just The Way You Are : Bruno Mars
King Of Anything : Sara Bareilles
Kush : Dr. Dre Featuring Snoop Dogg & Akon
Letting Go (Dutty Love) : Sean Kingston Featuring Nicki Minaj
Life After You : Daughtry
Like A G6 : Far*East Movement Featuring Cataracs & Dev
Like A Prayer : Glee Cast Featuring Lea Michele, Jonathan Groff, Cory Monteith, Chris Colfer & Amber Riley
Lil Freak : Usher Featuring Nicki Minaj
Live Like We're Dying : Kris Allen
Loca : Shakira Featuring El Cata or Dizzee Rascal
Lose My Mind : Young Jeezy Featuring Plies
Love Like Woe : The Ready Set
Love The Way You Lie : Eminem Featuring Rihanna
Lover, Lover : Jerrod Niemann
Magic : B.o.B Featuring Rivers Cuomo
Misery : Maroon 5
Miss Me : Drake Featuring Lil Wayne
Money To Blow : Birdman Featuring Lil Wayne & Drake
Monster : Kanye West Featuring Jay-Z, Rick Ross, Bon Iver & Nicki Minaj
My Chick Bad : Ludacris Featuring Nicki Minaj
My First Kiss : 3OH!3 Featuring Ke$ha
My Kinda Party : Jason Aldean
Naturally : Selena Gomez & The Scene
Need You Now : Lady Antebellum
Never Say Never : Justin Bieber Featuring Jaden Smith
No Hands : Waka Flocka Flame Featuring Roscoe Dash & Wale
No Love : Eminem Featuring Lil Wayne
Not Afraid : Eminem
Not Myself Tonight : Christina Aguilera
Nothin' On You : B.o.B Featuring Bruno Mars
OMG : Usher Featuring will.i.am
On To The Next One : Jay-Z + Swizz Beatz
POWER : Kanye West
Party In The U.S.A. : Miley Cyrus
Poker Face : Glee Cast
Power : Kanye West Featuring Dwele
Pray For You : Jaron And The Long Road To Love
Pretty Boy Swag : Soulja Boy Tell'em
Rain Is A Good Thing : Luke Bryan
Raise Your Glass : P!nk
Replay : Iyaz
Right Above It : Lil Wayne Featuring Drake
Rude Boy : Rihanna
Run This Town : Jay-Z, Rihanna & Kanye West
Runaway : Kanye West Featuring Pusha T
Say Aah : Trey Songz Featuring Fabolous
Say Something : Timbaland Featuring Drake
Sexy Chick : David Guetta Featuring Akon
Smile : Uncle Kracker
Somebody To Love : Justin Bieber
Stereo Love : Edward Maya & Vika Jigulina
Stranded (Haiti Mon Amour) : Jay-Z, Bono, The Edge & Rihanna
Stuck Like Glue : Sugarland
Sweet Dreams : Beyonce
Teach Me How To Dougie : Cali Swag District
Teenage Dream : Katy Perry
Telephone : Lady Gaga Featuring Beyonce
That's All She Wrote : T.I. Featuring Eminem
The Boys of Fall : Kenny Chesney
The Catalyst : Linkin Park
The House That Built Me : Miranda Lambert
The Only Exception : Paramore
There Goes My Baby : Usher
This Afternoon : Nickelback
TiK ToK : Ke$ha
Tie Me Down : New Boyz Feat. Ray J
Tie Me Down : New Boyz Featuring Ray J
Tonight (I'm Lovin' You) : Enrique Iglesias Featuring Ludacris & DJ Frank E
Total Eclipse Of The Heart : Glee Cast Featuring Jonathan Groff
Two Is Better Than One : Boys Like Girls Featuring Taylor Swift
Un-Thinkable (I'm Ready) : Alicia Keys
Undo It : Carrie Underwood
Use Somebody : Kings Of Leon
Waka Waka (This Time For Africa) : Shakira Featuring Freshlyground
We Are The World 25: For Haiti : Artists For Haiti
We No Speak Americano : Yolanda Be Cool & Dcup
What's My Name? : Rihanna Featuring Drake
Whataya Want From Me : Adam Lambert
Whatcha Say : Jason Derulo
Whip My Hair : Willow
Why Don't We Just Dance : Josh Turner
Winner : Jamie Foxx Featuring Justin Timberlake & T .I.
Yeah 3X : Chris Brown
You And Your Heart : Jack Johnson
You Belong With Me : Taylor Swift
Young Forever : Jay-Z + Mr. Hudson
Your Love : Nicki Minaj
