#SELFIE : The Chainsmokers
0 To 100 / The Catch Up : Drake
2 On : Tinashe Featuring ScHoolboy Q
23 : Mike WiLL Made-It Featuring Miley Cyrus, Wiz Khalifa & Juicy J
A Sky Full Of Stars : Coldplay
Ain't It Fun : Paramore
All About That Bass : Meghan Trainor
All I Want For Christmas Is You : Mariah Carey
All Me : Drake Featuring 2 Chainz & Big Sean
All Of Me : John Legend
Am I Wrong : Nico & Vinz
American Kids : Kenny Chesney
Amnesia : 5 Seconds Of Summer
Anaconda : Nicki Minaj
Animals : Martin Garrix
Applause : Lady Gaga
Automatic : Miranda Lambert
Bailando : Enrique Iglesias Featuring Descemer Bueno & Gente de Zona
Bang Bang : Jessie J, Ariana Grande & Nicki Minaj
Bartender : Lady Antebellum
Beachin' : Jake Owen
Beg For It : Iggy Azalea Featuring M0
Believe Me : Lil Wayne Featuring Drake
Best Day Of My Life : American Authors
Black Widow : Iggy Azalea Featuring Rita Ora
Blame : Calvin Harris Featuring John Newman
Blurred Lines : Robin Thicke Featuring T.I. + Pharrell
Boom Clap : Charli XCX
Booty : Jennifer Lopez Featuring Iggy Azalea Or Pitbull
Bottoms Up : Brantley Gilbert
Brave : Sara Bareilles
Break Free : Ariana Grande Featuring Zedd
Burn : Ellie Goulding
Burnin' It Down : Jason Aldean
Can't Remember To Forget You : Shakira Featuring Rihanna
Centuries : Fall Out Boy
Chandelier : Sia
Chillin' It : Cole Swindell
Classic : MKTO
CoCo : O.T. Genasis
Come With Me Now : KONGOS
Cool Kids : Echosmith
Dark Horse : Katy Perry Featuring Juicy J
Day Drinking : Little Big Town
Demons : Imagine Dragons
Dirt : Florida Georgia Line
Do What U Want : Lady Gaga Featuring R. Kelly
Doin' What She Likes : Blake Shelton
Don't : Ed Sheeran
Don't Tell 'Em : Jeremih Featuring YG
Drink To That All Night : Jerrod Niemann
Drunk In Love : Beyonce Featuring Jay Z
Drunk In Love : Beyonce Featuring Jay-Z
Drunk On A Plane : Dierks Bentley
EW! : Jimmy Fallon Featuring will.i.am
Fancy : Iggy Azalea Featuring Charli XCX
Fireball : Pitbull Featuring John Ryan
Gas Pedal : Sage The Gemini Featuring IamSu!
Give Me Back My Hometown : Eric Church
Guts Over Fear : Eminem Featuring Sia
Habits (Stay High) : Tove Lo
Hangover : PSY Featuring Snoop Dogg
Happy : Pharrell Williams
Heroes (We Could Be) : Alesso Featuring Tove Lo
Hey Brother : Avicii
Hold On, We're Going Home : Drake Featuring Majid Jordan
Hold You Down : DJ Khaled Featuring Chris Brown, August Alsina, Future & Jeremih
Holy Grail : Jay Z Featuring Justin Timberlake
Hot Boy : Bobby Shmurda
Human : Christina Perri
I Don't Dance : Lee Brice
I Don't F**k With You : Big Sean Featuring E-40
I Don't Mind : Usher Featuring Juicy J
It Won't Stop : Sevyn Streeter Featuring Chris Brown
Jealous : Nick Jonas
L.A.LOVE (la la) : Fergie
La La La : Naughty Boy Featuring Sam Smith
Latch : Disclosure Featuring Sam Smith
Leave The Night On : Sam Hunt
Let Her Go : Passenger
Let It Go : Idina Menzel
Life Of The Party : Shawn Mendes
Lifestyle : Rich Gang Featuring Young Thug & Rich Homie Quan
Love Me Again : John Newman
Love Me Harder : Ariana Grande & The Weeknd
Love More : Chris Brown Featuring Nicki Minaj
Love Never Felt So Good : Michael Jackson & Justin Timberlake
Love Runs Out : OneRepublic
Loyal : Chris Brown Featuring Lil Wayne & French Montana Or Too $hort
Loyal : Chris Brown Featuring Lil Wayne & French Montana Or Too $hort Or Tyga
Maps : Maroon 5
Mary, Did You Know? : Pentatonix
Me And My Broken Heart : Rixton
My Eyes : Blake Shelton Featuring Gwen Sebastian
My Hitta : YG Featuring Jeezy & Rich Homie Quan
Na Na : Trey Songz
Neon Lights : Demi Lovato
New Flame : Chris Brown Featuring Usher & Rick Ross
No Flex Zone : Rae Sremmurd
No Mediocre : T.I. Featuring Iggy Azalea
Not A Bad Thing : Justin Timberlake
Only : Nicki Minaj Featuring Drake, Lil Wayne & Chris Brown
Paranoid : Ty Dolla $ign Featuring B.o.B
Partition : Beyonce
Play It Again : Luke Bryan
Pompeii : Bastille
Problem : Ariana Grande Featuring Iggy Azalea
Rap God : Eminem
Rather Be : Clean Bandit Featuring Jess Glynne
Really Don't Care : Demi Lovato Featuring Cher Lloyd
Replay : Zendaya
Rewind : Rascal Flatts
Riptide : Vance Joy
Roar : Katy Perry
Rude : MAGIC!
Safe And Sound : Capital Cities
Sail : AWOLNATION
Say Something : A Great Big World & Christina Aguilera
Shake It Off : Taylor Swift
Shotgun Rider : Tim McGraw
Show Me : Kid Ink Featuring Chris Brown
Shower : Becky G
Somethin' Bad : Miranda Lambert Duet With Carrie Underwood
Something In The Water : Carrie Underwood
Stay The Night : Zedd Featuring Hayley Williams
Stay With Me : Sam Smith
Story Of My Life : One Direction
Studio : ScHoolboy Q Featuring BJ The Chicago Kid
Summer : Calvin Harris
Sweater Weather : The Neighbourhood
Take Me To Church : Hozier
Talk Dirty : Jason Derulo Featuring 2 Chainz
Team : Lorde
The Blower's Daughter : Matt McAndrew
The Hanging Tree : James Newton Howard Featuring Jennifer Lawrence
The Heart Wants What It Wants : Selena Gomez
The Man : Aloe Blacc
The Monster : Eminem Featuring Rihanna
This Is How We Roll : Florida Georgia Line Featuring Luke Bryan
This Is How We Roll : Florida Georgia Line Ft. Jason Derulo & Luke Bryan
Thriller : Michael Jackson
Timber : Pitbull Featuring Ke$ha
Trumpets : Jason Derulo
Tuesday : I LOVE MAKONNEN Featuring Drake
Turn Down For What : DJ Snake & Lil Jon
Uptown Funk! : Mark Ronson Featuring Bruno Mars
Waves : Mr. Probz
We Might Be Dead By Tomorrow : Soko
West Coast : Lana Del Rey
Whatever She's Got : David Nail
White Walls : Macklemore & Ryan Lewis Featuring ScHoolboy Q & Hollis
Wiggle : Jason Derulo Featuring Snoop Dogg
Wild Wild Love : Pitbull Featuring G.R.L.
Word Crimes : Weird Al Yankovic
Wrecking Ball : Miley Cyrus
Young Girls : Bruno Mars
i : Kendrick Lamar
