A Million To One : Jimmy Charles and The Revelletts
A Rockin' Good Way (To Mess Around And Fall In Love) : Dinah Washington & Brook Benton
A Thousand Stars : Kathy Young with The Innocents
Alley-Oop : Hollywood Argyles
Because They're Young : Duane Eddy And The Rebels
Beyond The Sea : Bobby Darin
Blue Angel : Roy Orbison
Burning Bridges : Jack Scott
Cathy's Clown : The Everly Brothers
Chain Gang : Sam Cooke
Corinna, Corinna : Ray Peterson
Cradle Of Love : Johnny Preston
Devil Or Angel : Bobby Vee
El Paso : Marty Robbins
Exodus : Ferrante & Teicher
Forever : The Little Dippers
Georgia On My Mind : Ray Charles
Go, Jimmy, Go : Jimmy Clanton
Good Timin' : Jimmy Jones
Greenfields : The Brothers Four
Happy-Go-Lucky-Me : Paul Evans
Harbor Lights : The Platters
He Will Break Your Heart : Jerry Butler
He'll Have To Go : Jim Reeves
He'll Have To Stay : Jeanne Black
Heartaches By The Number : Guy Mitchell
Hound Dog Man : Fabian
I Love The Way You Love : Marv Johnson
I Want To Be Wanted : Brenda Lee
Image Of A Girl : Safaris with The Phantom's Band
It's Time To Cry : Paul Anka
Itsy Bitsy Teenie Weenie Yellow Polkadot Bikini : Brian Hyland
Kiddio : Brook Benton
Last Date : Floyd Cramer
Let The Little Girl Dance : Billy Bland
Let's Go, Let's Go, Let's Go : Hank Ballard And The Midnighters
Let's Think About Living : Bob Luman
Lonely Blue Boy : Conway Twitty
Love You So : Ron Holden with The Thunderbirds
Many Tears Ago : Connie Francis
Mission Bell : Donnie Brooks
Mr. Custer : Larry Verne
Mule Skinner Blues : The Fendermen
New Orleans : U.S. Bonds
Night : Jackie Wilson
North To Alaska : Johnny Horton
O Dio Mio : Annette
Paper Roses : Anita Bryant
Please Help Me, I'm Falling : Hank Locklin
Poetry In Motion : Johnny Tillotson
Pretty Blue Eyes : Steve Lawrence
Sailor (Your Home Is The Sea) : Lolita
Save The Last Dance For Me : The Drifters
Sixteen Reasons : Connie Stevens
Stairway To Heaven : Neil Sedaka
Stay : Maurice Williams & The Zodiacs
Stuck On You : Elvis Presley With The Jordanaires
Swingin' School : Bobby Rydell
Teen Angel : Mark Dinning
The Big Hurt : Miss Toni Fisher
The Old Lamplighter : The Browns featuring Jim Edward Brown
The Theme From A Summer Place : Percy Faith And His Orchestra
The Twist : Chubby Checker
The Village Of St. Bernadette : Andy Williams
Walk -- Don't Run : The Ventures
Walking To New Orleans : Fats Domino
Way Down Yonder In New Orleans : Freddie Cannon
Where Or When : Dion & The Belmonts
White Silver Sands : Bill Black's Combo
Why : Frankie Avalon
Wonderland By Night : Bert Kaempfert And His Orchestra
Yogi : The Ivy Three
You Talk Too Much : Joe Jones
You're Sixteen : Johnny Burnette
