(I Can't Get No) Satisfaction : The Rolling Stones
1-2-3 : Len Barry
A Lover's Concerto : The Toys
Ain't That Peculiar : Marvin Gaye
All Day And All Of The Night : The Kinks
Amen : The Impressions
Baby Don't Go : Sonny & Cher
California Girls : The Beach Boys
Cara, Mia : Jay & The Americans
Cast Your Fate To The Wind : Sounds Orchestral
Crying In The Chapel : Elvis Presley With The Jordanaires
Do You Believe In Magic : The Lovin' Spoonful
Don't Just Stand There : Patty Duke
Down In The Boondocks : Billy Joe Royal
Downtown : Petula Clark
Eve Of Destruction : Barry McGuire
Ferry Cross The Mersey : Gerry And The Pacemakers
Game Of Love : Wayne Fontana & The Mindbenders
Go Now! : The Moody Blues
Goin' Out Of My Head : Little Anthony And The Imperials
Goldfinger : Shirley Bassey
Hang On Sloopy : The McCoys
Heart Full Of Soul : The Yardbirds
Hold Me, Thrill Me, Kiss Me : Mel Carter
Hold What You've Got : Joe Tex
Hush, Hush, Sweet Charlotte : Patti Page
I Can Never Go Home Anymore : The Shangri-Las
I Can't Help Myself (Sugar Pie Honey Bunch) : Four Tops
I Go To Pieces : Peter And Gordon
I Got You (I Feel Good) : James Brown And The Famous Flames
I Hear A Symphony : The Supremes
I Like It Like That : The Dave Clark Five
I Will : Dean Martin
I'll Never Find Another You : The Seekers
I'm Henry VIII, I Am : Herman's Hermits
I'm Telling You Now : Freddie And The Dreamers
It Ain't Me Babe : The Turtles
Just A Little : The Beau Brummels
Keep On Dancing : The Gentrys
Keep Searchin' (We'll Follow The Sun) : Del Shannon
King Of The Road : Roger Miller
Laugh At Me : Sonny
Let's Hang On! : The 4 Seasons Featuring the Sound of Frankie Valli
Like A Rolling Stone : Bob Dylan
Love Potion Number Nine : The Searchers
Make The World Go Away : Eddy Arnold
Mr. Lonely : Bobby Vinton
My Girl : The Temptations
Nowhere To Run : Martha & The Vandellas
Red Roses For A Blue Lady : Vic Dana
Rescue Me : Fontella Bass
Save Your Heart For Me : Gary Lewis And The Playboys
Seventh Son : Johnny Rivers
Shake : Sam Cooke
She's Not There : The Zombies
Shotgun : Jr. Walker & The All Stars
Taste Of Honey : Herb Alpert & The Tijuana Brass
The Birds And The Bees : Jewel Akens
The Boy From New York City : The Ad Libs
The In Crowd : Ramsey Lewis Trio
The Jerk : The Larks
The Jolly Green Giant : The Kingsmen
The Name Game : Shirley Ellis
The Sound Of Silence : Simon & Garfunkel
The Wedding : Julie Rogers
Treat Her Right : Roy Head And The Traits
Turn! Turn! Turn! (To Everything There Is A Season) : The Byrds
Unchained Melody : The Righteous Brothers
What The World Needs Now Is Love : Jackie DeShannon
What's New Pussycat? : Tom Jones
Wooly Bully : Sam The Sham and the Pharaohs
Yes, I'm Ready : Barbara Mason
Yesterday : The Beatles
You Turn Me On (Turn On Song) : Ian Whitcomb And Bluesville
You Were On My Mind : We Five
You're The One : The Vogues
You've Got To Hide Your Love Away : The Silkie
You've Got Your Troubles : The Fortunes
