A Different Corner : George Michael
Addicted To Love : Robert Palmer
Alive And Kicking : Simple Minds
All Cried Out : Lisa Lisa
All I Need Is A Miracle : Mike
Amanda : Boston
Baby Love : Regina
Bad Boy : Miami Sound Machine
Be Good To Yourself : Journey
Burning Heart : Survivor
C est La Vie : Robbie Nevil
Crush On You : The Jets
Dancing On The Ceiling : Lionel Richie
Danger Zone : Kenny Loggins
Don t Forget Me (When I m Gone) : Glass Tiger
Don't Get Me Wrong : Pretenders
Dreamtime : Daryl Hall
Everybody Have Fun Tonight : Wang Chung
Friends And Lovers : Carl Anderson
Glory Of Love (Theme From "The Karate Kid Part II") : Peter Cetera
Go Home : Stevie Wonder
Greatest Love Of All : Whitney Houston
Harlem Shuffle : The Rolling Stones
Heartbeat : Don Johnson
Higher Love : Steve Winwood
Holding Back The Years : Simply Red
Human : The Human League
I Can t Wait : Nu Shooz
I Miss You : Klymaxx
I m Your Man : Wham!
If You Leave : Orchestral Manoeuvres In The Dark
King For A Day : Thompson Twins
Kiss : Prince And The Revolution
Kyrie : Mr. Mister
Let s Go All The Way : Sly Fox
Life In A Northern Town : The Dream Academy
Live To Tell : Madonna
Living In America : James Brown
Love Touch (Theme From "Legal Eagles") : Rod Stewart
Mad About You : Belinda Carlisle
Manic Monday : Bangles
Modern Woman (From "Ruthless People") : Billy Joel
Nikita : Elton John
No One Is To Blame : Howard Jones
Nothin At All : Heart
Notorious : Duran Duran
On My Own : Patti LaBelle
Party All The Time : Eddie Murphy
Rock Me Amadeus : Falco
Rumors : Timex Social Club
Sara : Starship
Secret Lovers : Atlantic Starr
Separate Lives (Theme From White Nights) : Phil Collins/Marilyn Martin
Shake You Down : Gregory Abbott
Sledgehammer : Peter Gabriel
Small Town : John Mellencamp
Something About You : Level 42
Spies Like Us : Paul McCartney
Stand By Me : Ben E. King
Stuck With You : Huey Lewis
Sweet Freedom (Theme From "Running Scared") : Michael McDonald
Sweet Love : Anita Baker
Take Me Home : Phil Collins
Take Me Home Tonight : Eddie Money
Take My Breath Away (Love Theme From "Top Gun") : Berlin
Talk To Me : Stevie Nicks
Tender Love : Force M.D. s
That s What Friends Are For : Dionne
The Next Time I Fall : Peter Cetera With Amy Grant
The Rain : Oran Juice Jones
The Sweetest Taboo : Sade
The Way It Is : Bruce Hornsby
There ll Be Sad Songs (To Make You Cry) : Billy Ocean
This Could Be The Night : Loverboy
Throwing It All Away : Genesis
To Be A Lover : Billy Idol
Tonight She Comes : The Cars
True Colors : Cyndi Lauper
Tuff Enuff : The Fabulous Thunderbirds
Two Of Hearts : Stacey Q
Typical Male : Tina Turner
Venus : Bananarama
Walk Of Life : Dire Straits
Walk This Way : Run-D.M.C.
War : Bruce Springsteen
We Don t Have To Take Our Clothes Off : Jermaine Stewart
West End Girls : Pet Shop Boys
What You Need : INXS
When I Think Of You : Janet Jackson
Who s Johnny ("Short Circuit" Theme) : El DeBarge
Why Can t This Be Love : Van Halen
Word Up : Cameo
You Give Love A Bad Name : Bon Jovi
Your Love : The Outfield
Your Wildest Dreams : The Moody Blues
