(I Just) Died In Your Arms : Cutting Crew
(I ve Had) The Time Of My Life : Bill Medley
(You Gotta) Fight For Your Right (To Party!) : Beastie Boys
Alone : Heart
Always : Atlantic Starr
At This Moment : Billy Vera
At This Moment : Billy Vera & The Beaters
Bad : Michael Jackson
Ballerina Girl : Lionel Richie
Big Time : Peter Gabriel
Breakout : Swing Out Sister
Brilliant Disguise : Bruce Springsteen
C'est La Vie : Robbie Nevil
Can t We Try : Dan Hill (Duet With Vonda Shepard)
Carrie : Europe
Casanova : Levert
Catch Me (I'm Falling) (From The Film "Hiding Out") : Pretty Poison
Change Of Heart : Cyndi Lauper
Cherry Bomb : John Mellencamp
Diamonds : Herb Alpert Featuring Janet Jackson
Didn t We Almost Have It All : Whitney Houston
Doing It All For My Baby : Huey Lewis
Don t Disturb This Groove : The System
Don t Dream It s Over : Crowded House
Don't Get Me Wrong : Pretenders
Everybody Have Fun Tonight : Wang Chung
Funkytown : Pseudo Echo
Got My Mind Set On You : George Harrison
Head To Toe : Lisa Lisa
Heart And Soul : T Pau
Heat Of The Night : Bryan Adams
Heaven Is A Place On Earth : Belinda Carlisle
Here I Go Again : Whitesnake
I Heard A Rumour (From "Disorderlies") : Bananarama
I Just Can t Stop Loving You : Michael Jackson With Siedah Garrett
I Knew You Were Waiting (For Me) : Aretha Franklin
I Think We re Alone Now : Tiffany
I Want Your Sex (From "Beverly Hills Cop II") : George Michael
In Too Deep : Genesis
Is This Love : Survivor
It s A Sin : Pet Shop Boys
Just To See Her : Smokey Robinson
Keep Your Hands To Yourself : The Georgia Satellites
La Bamba : Los Lobos
Lean On Me : Club Nouveau
Let s Wait Awhile : Janet Jackson
Little Lies : Fleetwood Mac
Looking For A New Love : Jody Watley
Lost In Emotion : Lisa Lisa & Cult Jam Featuring Full Force
Love You Down : Ready For The World
Luka : Suzanne Vega
Mandolin Rain : Bruce Hornsby
Midnight Blue : Lou Gramm
Mony Mony : Billy Idol
Need You Tonight : INXS
Nothing s Gonna Stop Us Now : Starship
Notorious : Duran Duran
Only In My Dreams : Debbie Gibson
Point Of No Return : Expose
Respect Yourself : Bruce Willis
Rhythm Is Gonna Get You : Gloria Estefan
Right On Track : The Breakfast Club
Rock Steady : The Whispers
Shake You Down : Gregory Abbott
Shakedown (From "Beverly Hills Cop II") : Bob Seger
Should ve Known Better : Richard Marx
Sign O The Times : Prince
Someday : Glass Tiger
Somewhere Out There (From "An American Tail") : Linda Ronstadt
Songbird : Kenny G
Stand By Me : Ben E. King
Stone Love : Kool
Talk Dirty To Me : Poison
The Finer Things : Steve Winwood
The Lady In Red : Chris De Burgh
The One I Love : R.E.M.
The Way It Is : Bruce Hornsby & The Range
Touch Me (I Want Your Body) : Samantha Fox
Touch Of Grey : Grateful Dead
Walk Like An Egyptian : Bangles
Wanted Dead Or Alive : Bon Jovi
We ll Be Together : Sting
We re Ready : Boston
When Smokey Sings : ABC
Who s That Girl : Madonna
Will You Still Love Me? : Chicago
With Or Without You : U2
You Got It All : The Jets
You Keep Me Hangin On : Kim Wilde
