All For Love : Bryan Adams/Rod Stewart/Sting
All I Wanna Do : Sheryl Crow
Always : Bon Jovi
Another Night : Real McCoy
Any Time, Any Place/And On And On : Janet Jackson
Baby I Love Your Way (From "Reality Bites") : Big Mountain
Back : Aaliyah
Before I Let You Go : BLACKstreet
Bump N Grind : R. Kelly
Can You Feel The Love Tonight (From "The Lion King") : Elton John
Cantaloop (Flip Fantasia) : US 3
Creep : TLC
Don t Turn Around : Ace Of Base
Endless Love : Luther Vandross
Fantastic Voyage : Coolio
Flava In Ya Ear : Craig Mack
Funkdafied : Da Brat
Gangsta Lean : DRS
Getto Jam : Domino
Gin And Juice : Snoop Doggy Dogg
Here Comes The Hotstepper (From "Ready To Wear") : Ini Kamoze
I Swear : All-4-One
I Wanna Be Down : Brandy
I d Do Anything For Love (But I Won t Do That) : Meat Loaf
I ll Make Love To You : Boyz II Men
I ll Remember (From "With Honors") : Madonna
I m Ready : Tevin Campbell
I m The Only One : Melissa Etheridge
If You Go : Jon Secada
Linger : The Cranberries
Loser : Beck
Mmm Mmm Mmm Mmm : Crash Test Dummies
Never Lie : Immature
Now And Forever : Richard Marx
Please Forgive Me : Bryan Adams
Regulate (From "Above The Rim") : Warren G
Return To Innocence : Enigma
Said I Loved You...But I Lied : Michael Bolton
Shoop : Salt-N-Pepa
Stay (I Missed You) (From "Reality Bites") : Lisa Loeb
Streets Of Philadelphia (From "Philadelphia") : Bruce Springsteen
Stroke You Up : Changing Faces
The Most Beautiful Girl In The World : Prince
The Power Of Love : Celine Dion
Tootsee Roll : 69 Boyz
Understanding : Xscape
Whatta Man : Salt-N-Pepa Featuring En Vogue
When Can I See You : Babyface
Whoomp! (There It Is) : Tag Team
Wild Night : John Mellencamp With Me Shell Ndegeocello
Without You/Never Forget You : Mariah Carey
You Mean The World To Me : Toni Braxton
