4 Seasons Of Loneliness : Boyz II Men
All By Myself : Celine Dion
All Cried Out : Allure Featuring 112
Barbie Girl : Aqua
Been Around The World : Puff Daddy & The Family (Feat. The Notorious B.I.G. & Mase)
Bitch : Meredith Brooks
Can't Nobody Hold Me Down : Puff Daddy (Featuring Mase)
Candle In The Wind 1997/Something About The Way You Look Tonight : Elton John
Discotheque : U2
Don't Cry For Me Argentina (From "Evita") : Madonna
Don't Let Go (Love) (From "Set It Off") : En Vogue
Every Time I Close My Eyes : Babyface
Feel So Good : Mase
Fly Like An Eagle (From "Space Jam") : Seal
Foolish Games/You Were Meant For Me : Jewel
For You I Will (From "Space Jam") : Monica
G.H.E.T.T.O.U.T. : Changing Faces
Get It Together : 702
Hard To Say I'm Sorry : Az Yet Featuring Peter Cetera
Honey : Mariah Carey
How Do I Live : LeAnn Rimes
Hypnotize : The Notorious B.I.G.
I Believe I Can Fly (From "Space Jam") : R. Kelly
I Believe In You And Me (From "The Preacher s Wife") : Whitney Houston
I Belong To You (Every Time I See Your Face) : Rome
I Finally Found Someone (From "The Mirror Has Two Faces") : Barbra Streisand
I Want You : Savage Garden
I Will Come To You : Hanson
I ll Be Missing You : Puff Daddy
I m Still In Love With You : New Edition
I'll Be : Foxy Brown Featuring Jay-Z
I'll Be Missing You : Puff Daddy & Faith Evans Featuring 112
If It Makes You Happy : Sheryl Crow
In My Bed : Dru Hill
It's Your Love : Tim McGraw With Faith Hill
Last Night (From "The Nutty Professor") : Az Yet
Look Into My Eyes (From "Batman : Bone Thugs-N-Harmony
Macarena (Bayside Boys Mix) : Los Del Rio
Mo Money Mo Problems : The Notorious B.I.G. (Feat. Puff Daddy
Mo Money Mo Problems : The Notorious B.I.G. Featuring Puff Daddy & Mase
Mouth : Merril Bainbridge
My Baby Daddy : B-Rock & The Bizz
My Body : LSG
My Love Is The Shhh! : Somethin' For The People Featuring Trina & Tamara
No Diggity : BLACKstreet (Featuring Dr. Dre)
Nobody : Keith Sweat Featuring Athena Cage
Not Tonight : Lil Kim Feat. Da Brat, Left Eye, Missy Elliott
Not Tonight : Lil' Kim Feat. Da Brat, Left Eye, Missy Elliott & Angie Mar
Quit Playing Games (With My Heart) : Backstreet Boys
Return Of The Mack : Mark Morrison
Semi-Charmed Life : Third Eye Blind
Show Me Love : Robyn
Sunny Came Home : Shawn Colvin
The Freshmen : The Verve Pipe
The One I Gave My Heart To : Aaliyah
Together Again : Janet
Tubthumping : Chumbawamba
Un-Break My Heart : Toni Braxton
Wannabe : Spice Girls
Where Have All The Cowboys Gone? : Paula Cole
You Make Me Wanna... : Usher
