(Hot S**t) Country Grammar : Nelly
Absolutely (Story Of A Girl) : Nine Days
All The Small Things : Blink-182
Amazed : Lonestar
Auld Lang Syne : Kenny G
Back At One : Brian McKnight
Bag Lady : Erykah Badu
Be With You : Enrique Iglesias
Bent : matchbox twenty
Blue (Da Ba Dee) : Eiffel 65
Breathe : Faith Hill
Bring It All To Me : Blaque
Bye Bye Bye : N Sync
Case Of The Ex (Whatcha Gonna Do) : Mya
Dance With Me : Debelah Morgan
Doesn t Really Matter : Janet
Everything You Want : Vertical Horizon
Get It On Tonite : Montell Jordan
Girl On TV : LFO
Give Me Just One Night (Una Noche) : 98 Degrees
Gotta Tell You : Samantha Mumba
He Loves U Not : Dream
He Wasn t Man Enough : Toni Braxton
Hot Boyz : Missy "Misdemeanor" Elliott Featuring NAS, EVE
Hot Boyz : Missy "Misdemeanor" Elliott Featuring NAS, EVE & Q-Tip
I Knew I Loved You : Savage Garden
I Try : Macy Gray
I Wanna Know : Joe
I Wanna Love You Forever : Jessica Simpson
Independent Women Part I : Destiny's Child
It Feels So Good : Sonique
It Wasn t Me : Shaggy Featuring Ricardo "RikRok" Ducent
It's Gonna Be Me : 'N Sync
Kryptonite : 3 Doors Down
Maria Maria : Santana Featuring The Product G
Ms. Jackson : OutKast
Music : Madonna
My Love Is Your Love : Whitney Houston
No More : Ruff Endz
Oops!...I Did It Again : Britney Spears
Say My Name : Destiny s Child
Show Me The Meaning Of Being Lonely : Backstreet Boys
Smooth : Santana Featuring Rob Thomas
Thank God I Found You : Mariah Carey Featuring Joe
That s The Way It Is : Celine Dion
The Real Slim Shady : Eminem
There You Go : Pink
Thong Song : Sisqo
Try Again : Aaliyah
U Know What's Up : Donell Jones
What A Girl Wants : Christina Aguilera
Wifey : Next
With Arms Wide Open : Creed
You Sang To Me : Marc Anthony
