'03 Bonnie & Clyde : Jay-Z Featuring Beyonce Knowles
7 Days : Craig David
A Moment Like This : Kelly Clarkson
A Thousand Miles : Vanessa Carlton
A Woman's Worth : Alicia Keys
Addictive : Truth Hurts Featuring Rakim
Ain't It Funny : Jennifer Lopez Featuring Ja Rule
Air Force Ones : Nelly Featuring Kyjuan, Ali & Murphy Lee
All You Wanted : Michelle Branch
Always On Time : Ja Rule Featuring Ashanti
Beautiful : Christina Aguilera
Blurry : Puddle Of Mudd
Bump, Bump, Bump : B2K & P. Diddy
Can't Get You Out Of My Head : Kylie Minogue
Cleanin' Out My Closet : Eminem
Complicated : Avril Lavigne
Die Another Day : Madonna
Differences : Ginuwine
Dilemma : Nelly Featuring Kelly Rowland
Don't Mess With My Man : Nivea Featuring Brian & Brandon Casey
Down 4 U : Irv Gotti Presents The Inc. Featuring Ja Rule, Ashanti, Charli Baltimore & Vita
Family Affair : Mary J. Blige
Gangsta Lovin' : Eve Featuring Alicia Keys
Get The Party Started : Pink
Gimme The Light : Sean Paul
Girlfriend : 'N Sync Featuring Nelly
Gotta Get Thru This : Daniel Bedingfield
Happy : Ashanti
Heaven : DJ Sammy & Yanou Featuring Do
Hero : Chad Kroeger Featuring Josey Scott
Hero : Enrique Iglesias
Hey Baby : No Doubt Featuring Bounty Killer
Hey Ma : Cam'ron Featuring Juelz Santana, Freekey Zekey & Toya
Hot In Herre : Nelly
How You Remind Me : Nickelback
I Need A Girl (Part One) : P. Diddy Featuring Usher & Loon
I Need A Girl (Part Two) : P. Diddy & Ginuwine Featuring Loon, Mario Winans & Tammy Ruggeri
I'm Gonna Be Alright : Jennifer Lopez Featuring Nas
In The End : Linkin Park
Jenny From The Block : Jennifer Lopez Featuring Jadakiss & Styles
Just A Friend 2002 : Mario
Long Time Gone : Dixie Chicks
Luv U Better : LL Cool J
Move B***h : Ludacris Featuring Mystikal & Infamous 2.0
My Sacrifice : Creed
Nothin' : N.O.R.E.
Oh Boy : Cam'ron Featuring Juelz Santana
Oops (Oh My) : Tweet
The Game Of Love : Santana Featuring Michelle Branch
The Middle : Jimmy Eat World
U Got It Bad : Usher
Underneath It All : No Doubt Featuring Lady Saw
What About Us? : Brandy
What's Luv? : Fat Joe Featuring Ashanti
Whenever, Wherever : Shakira
Wherever You Will Go : The Calling
Work It : Missy "Misdemeanor" Elliott
