(When You Gonna) Give It Up To Me : Sean Paul Feat. Keyshia Cole
(When You Gonna) Give It Up To Me : Sean Paul Featuring Keyshia Cole
Ain't No Other Man : Christina Aguilera
Bad Day : Daniel Powter
Be Without You : Mary J. Blige
Breaking Free : Zac Efron & Vanessa Anne Hudgens
Buttons : The Pussycat Dolls Featuring Snoop Dogg
Call Me When You're Sober : Evanescence
Chain Hang Low : Jibbs
Chasing Cars : Snow Patrol
Check On It : Beyonce Featuring Slim Thug
Come To Me : Diddy Featuring Nicole Scherzinger
Control Myself : LL Cool J Featuring Jennifer Lopez
Crazy : Gnarls Barkley
Dance, Dance : Fall Out Boy
Dani California : Red Hot Chili Peppers
Deja Vu : Beyonce Featuring Jay-Z
Dirty Little Secret : The All-American Rejects
Do I Make You Proud : Taylor Hicks
Don't Forget About Us : Mariah Carey
Everytime We Touch : Cascada
Get Up : Ciara Featuring Chamillionaire
Gold Digger : Kanye West Featuring Jamie Foxx
Grillz : Nelly Featuring Paul Wall, Ali & Gipp
Hips Don't Lie : Shakira Featuring Wyclef Jean
I Wanna Love You : Akon Featuring Snoop Dogg
I Write Sins Not Tragedies : Panic! At The Disco
I'm N Luv (Wit A Stripper) : T-Pain Featuring Mike Jones
Irreplaceable : Beyonce
It's Goin' Down : Yung Joc
Laffy Taffy : D4L
Lean Wit It, Rock Wit It : Dem Franchize Boyz Featuring Lil Peanut & Charlay
Lips Of An Angel : Hinder
London Bridge : Fergie
Me & U : Cassie
Money Maker : Ludacris Featuring Pharrell
Ms. New Booty : Bubba Sparxxx Featuring Ying Yang Twins & Mr. ColliPark
My Humps : The Black Eyed Peas
My Love : Justin Timberlake Featuring T.I.
Over My Head (Cable Car) : The Fray
Photograph : Nickelback
Promiscuous : Nelly Furtado Featuring Timbaland
Pullin' Me Back : Chingy Featuring Tyrese
Ridin' : Chamillionaire Featuring Krayzie Bone
SOS : Rihanna
Say It Right : Nelly Furtado
SexyBack : Justin Timberlake
Shake That : Eminem Featuring Nate Dogg
Shortie Like Mine : Bow Wow Featuring Chris Brown & Johnta Austin
Shoulder Lean : Young Dro Featuring T.I.
Show Me What You Got : Jay-Z
Show Stopper : Danity Kane
Smack That : Akon Featuring Eminem
Snap Yo Fingers : Lil Jon Featuring E-40 & Sean Paul Of The YoungBloodZ
So Sick : Ne-Yo
So What : Field Mob Featuring Ciara
Stickwitu : The Pussycat Dolls
Temperature : Sean Paul
There It Go! (The Whistle Song) : Juelz Santana
Too Little Too Late : JoJo
Unpredictable : Jamie Foxx Featuring Ludacris
Unwritten : Natasha Bedingfield
We Fly High : Jim Jones
What Hurts The Most : Rascal Flatts
What You Know : T.I.
What's Left Of Me : Nick Lachey
Where'd You Go : Fort Minor Featuring Holly Brook
White & Nerdy : Weird Al Yankovic
Wind It Up : Gwen Stefani
Yo (Excuse Me Miss) : Chris Brown
You're Beautiful : James Blunt
